issue,theme,긍정,부정,중립,total
판매 완료,가격 및 거래,0,0,292,292
개인거래,가격 및 거래,0,0,227,227
개인 거래,기타,0,0,180,180
특가,기타,3,0,109,112
성능 궁금증,기타,0,0,110,110
가격,기타,2,1,102,105
저렴한 가격,기타,64,0,37,101
미개봉 새상품,제품 상태 및 거래 조건,2,0,97,99
판매완료,거래 및 구매,0,0,94,94
미개봉 제품,제품 상태 및 거래,1,0,78,79
직접결제 가능,거래 및 구매,0,0,75,75
판매 중,가격 및 거래,0,0,73,73
가격 정보,가격 및 구매 정보,0,0,73,73
안전결제,거래 및 구매,4,0,62,66
직접결제,가격 및 거래,0,0,63,63
직거래 가능,제품 상태 및 거래,1,0,59,60
가격 궁금증,기타,0,0,60,60
무거움,제품 이동성 및 설치,0,51,6,57
직거래,거래 및 구매,0,0,56,56
직접 결제 가능,제품 판매 및 혜택,0,0,51,51
금액 궁금증,가격 및 거래,0,0,49,49
휴대성,이동성과 휴대성,33,0,15,48
미개봉 새제품,기타,3,0,45,48
핫딜,가격 및 거래,0,0,44,44
"가격 750,000원",가격 및 거래,0,0,44,44
직거래 및 택배거래 가능,거래 및 구매,0,0,42,42
중고나라 노출,기타,0,0,40,40
"가격 700,000원",가격 및 거래,0,0,39,39
미개봉 상품,제품 상태 및 거래,0,0,39,39
직접 결제,기타,0,0,38,38
"가격 800,000원",가격 및 구매,0,0,36,36
"가격 850,000원",가격 및 거래 조건,0,0,35,35
거래 희망 지역,거래 및 구매,0,0,33,33
이동 편리,제품 이동성 및 설치,31,0,1,32
성능,기타,2,0,30,32
새상품,구매 및 거래,3,0,28,31
네이버페이,기타,1,0,29,30
인기 제품,사용자 경험 및 만족도,18,0,12,30
할인,제품 구매 및 기대,11,0,17,28
"가격 650,000원",제품 구매 및 거래,0,0,27,27
안전 결제,구매 및 거래,2,0,23,25
캠핑에서 사용,캠핑 및 외부 활동,12,0,13,25
판매중,가격 및 거래,0,0,25,25
"가격 600,000원",가격 및 거래,0,0,25,25
방문 설치,편의성과 활용,0,0,24,24
안전결제 가능,가격 및 거래,6,0,18,24
가격 할인,가격 및 경제성,21,0,2,23
할인 정보,가격 및 구매 옵션,4,0,18,22
할인된 가격,가격 및 구매,16,0,6,22
이동 가능,이동 및 사용 편의성,12,0,10,22
높은 가격,가격 및 구매,0,18,4,22
이동식 TV 거치대,기타,0,0,21,21
거래 방법,거래 및 구매,0,0,20,20
포터블 스크린,디자인 및 외관,1,0,19,20
큰 화면,기타,15,0,5,20
자동 노출,구매 옵션 및 서비스,0,0,19,19
내구성,기능 및 성능,17,0,2,19
"가격 900,000원",거래 및 가격,0,0,19,19
비싼 가격,가격 및 구매,0,19,0,19
스탠바이미 구매 고려,구매 및 소비자 경험,0,0,18,18
이동식 TV,제품 디자인 및 이동성,0,0,18,18
스탠바이미 구매 고민,고객 만족 및 리뷰,0,1,16,17
자유로운 이동,이동성과 휴대성,16,0,1,17
기능에 대한 궁금증,제품 기능 및 성능,0,0,16,16
중고나라 앱/사이트 노출,거래 및 가격,0,0,16,16
직거래만 가능,제품 상태 및 거래,0,0,16,16
이동성,이동성과 휴대성,10,0,5,15
예쁜 디자인,디자인 및 크기,14,0,0,14
새제품,제품 상태 및 제조 정보,2,0,12,14
좋은 제품,인기 및 시장 반응,14,0,0,14
빠른 배송,기타,12,0,2,14
네이버페이 사용,구매 옵션 및 서비스,0,0,14,14
미개봉,기타,0,0,14,14
프라이빗 스크린,이동 및 사용 편의성,3,0,10,13
중고나라 앱,기타,0,0,13,13
고객 직접 설치,제품 이동성 및 설치,0,0,13,13
퀄리티,기타,2,0,11,13
스탠드형,기타,0,0,13,13
빠른 판매 가능,기타,2,0,11,13
고선명 클리어 타입,기타,4,0,9,13
일체형 디자인,디자인 및 공간 활용,2,0,11,13
미개봉 상태,제품 상태 및 신뢰성,1,0,12,13
스탠바이미 추천,마케팅 및 프로모션,11,0,2,13
다양한 기능,제품 스펙 및 기능,12,0,0,12
모바일 화면 공유 가능,사용 용도 및 기능,2,0,10,12
제품 정보 탐색,기타,0,0,12,12
새 제품,기타,3,0,9,12
편리한 사용,편의성과 활용,12,0,0,12
가성비 좋음,가격 및 경제성,12,0,0,12
캠핑에 적합,기타,7,0,4,11
스탠바이미 인기,기타,4,0,7,11
FHD 해상도,제품 기능 및 기술,0,0,11,11
미사용 제품,기타,4,0,7,11
구매 욕구,마케팅 및 이벤트,6,0,5,11
할인 검색,이벤트 및 혜택,0,0,11,11
디자인,기타,4,0,7,11
이벤트 참여,이벤트 및 프로모션,1,0,10,11
구매 고민,제품 구매 및 만족도,0,1,10,11
고화질 화면,화질 및 시청 경험,10,0,0,10
편리함,기타,8,0,2,10
기능 궁금증,기타,0,0,10,10
이동 용이,기타,8,0,2,10
캠핑에서 유용,사용 장소 및 활용,9,0,1,10
성능에 대한 궁금증,기타,0,0,10,10
무게,기타,0,3,7,10
거래 지역,거래 및 구매,0,0,10,10
유튜브 시청,편의성과 활용,1,0,9,10
직거래 선호,구매 옵션 및 서비스,0,0,10,10
편리한 이동,이동 및 휴대성,9,0,0,9
"가격 680,000원",제품 구매 및 거래,0,0,9,9
직거래 희망,거래 및 배송,0,0,9,9
가격 인하,가격 및 거래,4,0,5,9
무선 사용 가능,제품 기능 및 기술,5,0,4,9
미개봉 제품 판매,제품 구매 및 거래,0,0,9,9
가격 차이,기타,0,1,8,9
선명한 화질,화질 및 성능,9,0,0,9
이동식 스탠드,이동성과 휴대성,3,0,6,9
거래 방법 다양,구매 및 거래,0,0,9,9
중고나라 앱 사용,기타,0,0,9,9
스탠바이미 구매,제품 구매 및 기대,3,0,6,9
가격 비교,제품 비교 및 구매 고려,0,0,9,9
직거래 원함,제품 구매 및 거래,0,0,9,9
깔끔한 디자인,디자인 및 인테리어,9,0,0,9
"가격 730,000원",가격 및 거래,0,0,9,9
금액,구매 및 거래,0,0,8,8
네이버페이 송금,부가 서비스 및 결제,0,0,8,8
스탠바이미고 구매,구매 및 가격,0,0,8,8
스탠바이미 고 출시,제품 혁신 및 신제품,1,0,7,8
캠핑용 구매,기타,0,0,8,8
제품 만족,사용자 경험 및 만족도,8,0,0,8
좋은 화질,화질 및 화면,7,0,1,8
인기 있는 제품,인기 및 시장 반응,5,0,3,8
경품 이벤트,이벤트 및 프로모션,0,0,7,7
야외 사용 가능,기타,6,0,1,7
디자인 만족,디자인 및 공간 활용,7,0,0,7
좋은 후기,사용자 경험 및 만족도,7,0,0,7
이쁜 디자인,제품 디자인 및 이동성,7,0,0,7
퀄리티 좋은 제품,제품 정보 및 추천,1,0,6,7
한정판,제품 출시 및 인지도,0,0,7,7
직거래 위치,구매 및 거래 위치,0,0,7,7
캠핑용 TV,디자인 및 혁신,1,0,6,7
편의성,제품 만족도 및 인기,2,0,5,7
규칙 확인 필요,기타,0,0,7,7
흠집 없음,제품 상태 및 거래 조건,5,0,2,7
캠핑,기타,0,0,7,7
캐리백 디자인,제품 디자인 및 이동성,3,0,4,7
택배 가능,기타,1,0,6,7
내장 배터리,기능 및 기술,1,0,6,7
위치 정보,사용 및 설치,0,0,7,7
화질,기능 및 성능,1,0,6,7
캠핑에서 사용 가능,이동식 스마트 TV,4,0,3,7
휴대 편리,제품 내구성 및 휴대성,7,0,0,7
스마트 TV,기능 및 성능,0,0,7,7
세련된 디자인,디자인 및 공간 활용,7,0,0,7
제품 정보,기타,0,0,7,7
할인 가격,가격 및 구매 정보,3,0,4,7
캠핑용 사용,사용 용도 및 적합성,0,0,7,7
거의 사용 안함,제품 상태 및 거래,1,0,6,7
가격에 대한 궁금증,가격 및 거래,0,0,7,7
할인 행사,가격 및 구매,2,0,5,7
다양한 활용,기타,6,0,1,7
스탠바이미 판매,기타,0,0,7,7
캠핑용 모니터,캠핑 및 휴대성,3,0,4,7
후기 고려,제품 평가 및 후기,0,0,7,7
상품 노출,기타 기능 및 고민,0,0,6,6
핫딜 정보,가격 및 거래,0,0,6,6
스피커,제품 디자인 및 기능,0,0,6,6
규칙 확인 요청,기타,0,0,6,6
배송,기타,0,0,6,6
스탠바이미 렌탈,렌탈 및 구독 서비스,0,0,6,6
배송 고려,기타,0,0,6,6
"가격 630,000원",가격 및 구매,0,0,6,6
단순 개봉,제품 상태 및 제조 정보,0,0,6,6
스탠드형 디자인,제품 기능 및 디자인,1,0,5,6
"가격 820,000원",거래 및 가격,0,0,6,6
스탠바이미 만족,제품 만족도,6,0,0,6
캠핑용,아웃도어 및 캠핑,2,0,4,6
캠핑템,캠핑 및 야외 활동,0,0,6,6
"가격 950,000원",거래 및 가격,0,0,6,6
사용하지 않음,기능 및 사용,0,0,6,6
네이버페이 사용 가능,기타,0,0,6,6
선착순 한정,기타,0,0,6,6
구매 망설임,기타,0,0,6,6
OTT 시청,사용 용도 및 기능,2,0,4,6
LG 스탠바이미,브랜드 및 모델,0,0,6,6
음악 감상,제품 사용 경험,4,0,2,6
최저가,가성비 및 가격,3,0,3,6
"가격 550,000원",가격 및 거래,0,0,6,6
미러링 기능,기타,1,0,5,6
모바일 화면 공유,기능 및 사용 편의성,3,0,3,6
스탠바이미고 판매,제품 상태 및 판매,0,0,6,6
휴대용 TV,기타,3,0,3,6
모바일 NFC 기능,기타,3,0,3,6
미개봉 신상품,제품 상태 및 거래,0,0,6,6
스탠바이미 핫딜,구매 및 거래,0,0,6,6
박스 없음,제품 상태 및 거래,0,0,6,6
특가 제공,사용자 경험 및 만족도,1,0,5,6
중고나라 앱 홍보,기타,0,0,5,5
휴대 가능,기타,5,0,0,5
빠른 설치,제품 설치 및 사용,4,0,1,5
렌탈 특가,가격 및 거래,0,0,5,5
스탠바이미 관심,제품 정보 및 추천,0,0,5,5
거래방법: 직거래,구매 및 거래,0,0,5,5
이동형 TV,제품 특성 및 기능,1,0,4,5
합리적인 가격,제품 구매 및 가격,4,0,1,5
스탠바이미 구매 희망,기타,2,0,3,5
캠핑장에서 사용,캠핑 및 야외활동,2,0,3,5
다용도 사용,기타,3,0,2,5
LG 스탠바이미고,기타,0,0,5,5
박스 있음,구매 및 거래,0,0,5,5
캠핑용품,캠핑 및 휴대성,0,0,5,5
직거래 우선,거래 및 가격,0,0,5,5
박스 미개봉,가격 및 상태,0,0,5,5
고화질,화질 및 시청 경험,4,0,1,5
판매,제품 상태 및 판매,0,0,5,5
빠른 품절,가격 및 구매,2,1,2,5
높이 조절 가능,기능 및 사용성,2,0,3,5
가격 부담,가격 및 경제성,0,5,0,5
휴대성 강조,기타,1,0,4,5
구매처 공유,거래 및 구매,1,0,4,5
터치 기능,기능 및 성능,4,0,1,5
구매 추천,사용자 경험 및 만족도,5,0,0,5
"가격 690,000원",가격 및 거래 조건,0,0,5,5
편안함,디자인 및 기능,0,0,5,5
무선 TV,제품 성능 및 기능,1,0,4,5
캠핑 및 여행에서 사용,편의성과 활용,3,0,2,5
택배거래 가능,제품 상태 및 거래,0,0,5,5
스탠바이미 2세대,제품 홍보 및 출시 기대,0,0,5,5
"가격 780,000원",제품 구매 및 거래,0,0,5,5
"가격 790,000원",구매 및 가격 관련,0,0,5,5
"가격 830,000원",거래 및 가격,0,0,5,5
저렴한 구매,구매 및 이벤트,4,0,1,5
사은품 제공,기타,1,0,4,5
TV 미시청,기타,0,0,5,5
구매 만족,제품 만족도,5,0,0,5
가격 고민,가격 및 구매,0,0,5,5
노출 안내,광고 및 마케팅,0,0,5,5
최저가 기회,마케팅 및 프로모션,3,0,2,5
높은 별점,사용자 경험 및 만족도,5,0,0,5
가성비,가성비 및 가격,4,0,1,5
가벼운 무게,제품 디자인 및 크기,5,0,0,5
인기,인기 및 시장 반응,3,0,2,5
렌탈 가능,가격 및 구매,0,0,5,5
배송 지연,이동 및 설치,0,5,0,5
방문설치,기타,0,0,5,5
경품 제공,이벤트 및 혜택,1,0,4,5
가정에서 사용,활용 및 용도,2,0,3,5
라이프스타일 스크린,캠핑 및 휴대성,0,0,5,5
터치 디스플레이,제품 기능 및 기술,0,0,4,4
거치대,기타,0,0,4,4
부피 큼,기타,0,0,4,4
"가격 750,000 원",구매 및 가격 관련,0,0,4,4
스탠바이미고,기타,0,0,4,4
거의 새 제품,제품 상태 및 거래,4,0,0,4
정가 양도,가격 및 거래,0,0,4,4
노출 관련 안내,기타,0,0,4,4
피크닉에서 사용,구성 및 설치,3,0,1,4
"가격 1,000,000원",가격 및 상태,0,0,4,4
핸드폰 미러링,기타,1,0,3,4
스탠바이미 TV,제품 특성 및 용도,0,0,4,4
"가격 1,050,000원",제품 및 가격 정보,0,0,4,4
할인 제품,가격 및 구매 고려,2,0,2,4
택배 거래 가능,구매 및 거래,0,0,4,4
다양한 스크린 모드,사용자 경험 및 기능,1,0,3,4
가격 협상 가능,거래 및 가격,0,0,4,4
구입 3-4개월,제품 상태 및 거래 조건,0,0,4,4
캠핑 감성,라이프스타일 및 경험,1,0,3,4
사기글,기타,0,4,0,4
스탠바이미 특가,가격 및 구매,0,0,4,4
스탠바이미 구매 만족,스탠바이미 제품 및 기능,4,0,0,4
제품 고장,문제 및 불만,0,4,0,4
LG 스탠바이미 공식 카페 초대,제품 판매 및 혜택,0,0,4,4
"거래방법: 직거래, 택배거래",기타,0,0,4,4
직접결제(네이버페이 송금),거래 및 구매,0,0,4,4
새 상품,제품 상태 및 신뢰성,0,0,4,4
인기 많음,제품 구매 및 결정,1,0,3,4
판매량 많음,기타,3,0,1,4
야외 사용,캠핑 및 야외 활동,1,0,3,4
터치 사용,기술 및 기능,1,0,3,4
블루라이트 차단,기타,2,0,2,4
새상품 상태,제품 상태 및 가격,4,0,0,4
집에서 사용,기타,1,0,3,4
캠핑용 포터블 모니터,캠핑 및 야외 활용,3,0,1,4
조용한 술집,기타,4,0,0,4
하프스터디 신청 혜택,기타,1,0,3,4
27인치 디스플레이,제품 기능 및 디자인,0,0,4,4
뛰어난 휴대성,이동 및 휴대성,4,0,0,4
최저가 구매,가격 및 구매,1,0,3,4
실용성,기타,3,0,1,4
캠핑 빔프로젝터,기타,0,0,4,4
많은 관심,제품 평가 및 후기,0,0,4,4
실사용시간 1시간 미만,제품 상태 및 거래 조건,0,0,4,4
스탠바이미 고,제품 및 브랜드 인식,0,0,4,4
구매 고려,구매 및 경제성,0,0,4,4
캠핑 사용,사용 용도 및 기능,0,0,4,4
디자인 예쁨,디자인 및 편의성,4,0,0,4
가격 다양성,가격 및 거래,0,0,4,4
분위기 좋은 술집,기타,4,0,0,4
신제품,구매 및 소비자 경험,0,0,4,4
대형 스크린,화면 및 콘텐츠,0,0,4,4
화면 회전 가능,기능 및 사용 편의성,1,0,3,4
미개봉 새제품 판매,제품 상태 및 거래,0,0,4,4
"가격 2,000원",제품 및 가격 정보,0,0,4,4
예약 중,기타,0,0,4,4
제품 기능 궁금증,제품 기능 및 사용,0,0,4,4
다양한 기기 연결 가능,기술 및 기능,2,0,2,4
특가 정보,구매 및 거래,0,0,4,4
거래방법,기타,0,0,4,4
캠핑 및 가정에서 사용,사용 환경 및 조건,3,0,1,4
화면 미러링,기능 및 성능,2,0,2,4
화면 크기,기타,1,0,3,4
개인 거래 완료,거래 및 가격,0,0,4,4
"가격 870,000원",제품 상태 및 가격,0,0,4,4
미개봉 신품,제품 상태 및 제조 정보,0,0,4,4
스탠바이미go 핫딜,구매 및 거래,0,0,4,4
구매 시기,구매 및 거래,0,0,4,4
빠른 완판,기타,4,0,0,4
이벤트,제품 출시 및 홍보,0,0,4,4
이벤트 경품,이벤트 및 프로모션,0,0,4,4
삶의 질 향상,사용자 경험 및 만족도,4,0,0,4
유튜브 및 넷플릭스 시청,제품 기능 및 사용성,3,0,1,4
제품 인기,인기 및 시장 반응,2,0,2,4
튼튼한 내구성,제품 내구성 및 성능,4,0,0,4
침대에서 TV 시청,사용 환경 및 편리성,3,0,1,4
2세대 모델,신제품 및 모델,0,0,4,4
우수한 음질,기능 및 성능,4,0,0,4
"가격 810,000원",제품 상태 및 가격,0,0,4,4
"가격 590,000원",제품 상태 및 가격,0,0,4,4
상태 좋음,기타,4,0,0,4
이벤트 혜택,이벤트 및 혜택,1,0,3,4
제품 판매,거래 및 구매,0,0,4,4
LED 디스플레이,제품 기능 및 기술,0,0,4,4
급처,기타,0,0,4,4
게임 가능,제품 특성 및 기능,0,0,4,4
개봉일,영화 및 미디어,0,0,4,4
개인거래 완료,거래 및 구매,0,0,4,4
새제품 미개봉,거래 및 구매,0,0,4,4
출고가,가격 및 프로모션,0,0,4,4
휴대용 소형 포터블 TV,이동 및 휴대성,0,0,4,4
음성인식 기능,기능 및 사용성,1,0,3,4
이동식 모니터,이동 및 휴대성,1,0,3,4
제품명: 스탠바이미고,기타,0,0,4,4
스탠바이미 제품,기타,0,0,4,4
스마트 기능,기능 및 성능,1,0,3,4
스탠바이미 및 사운드바 판매,제품 판매 및 혜택,0,0,4,4
터치스크린,기타,3,0,1,4
이동식 스탠드 거치대,이동 및 사용 편의성,0,0,4,4
미러링,기능 및 성능,1,0,3,4
NFC 기능,기능 및 성능,2,0,1,3
강력한 내구성,제품 내구성 및 휴대성,3,0,0,3
높은 활용도,디자인 및 공간 활용,3,0,0,3
사용 기간,기타,0,0,3,3
캠핑 TV 추천,제품 추천 및 체험,2,0,1,3
전용가방 포함,제품 특징 및 비교,0,0,3,3
스탠바이미 고 가격,가격 및 할인,0,0,3,3
생산성,디자인 및 기능,0,0,3,3
캠핑 필수 아이템,사용 환경 및 장소,3,0,0,3
택배 배송 가능,거래 및 배송 관련,0,0,3,3
사용 계획 없음,제품 특징 및 활용,0,0,3,3
스탠바이미 제공,기타,1,0,2,3
새상품 판매,제품 상태 및 사용,0,0,3,3
괜찮은 화질,사용자 경험,3,0,0,3
스탠바이미 선택 만족,기타,3,0,0,3
LP바,기타,0,0,3,3
이용규칙,기타,0,0,3,3
뛰어난 성능,성능 및 기술,3,0,0,3
사용 기간: 6개월,구매 및 거래,0,0,3,3
새제품 판매,제품 상태 및 판매,0,0,3,3
초캠장터 규칙,기타,0,0,3,3
모바일 리모컨 지원,사용 만족 및 편의성,1,0,2,3
택배 배송,배송 및 수령,0,0,3,3
높은 인기,고객 만족 및 리뷰,3,0,0,3
모델명,기타,0,0,3,3
모델명 27LX5QKNA,제품 활용 및 기능,0,0,3,3
외부 사용 없음,제품 특징 및 사용,0,0,3,3
휴대용 모니터,캠핑 및 휴대성,0,0,3,3
모델명 차이,기타,0,0,3,3
튼튼한 스탠드,내구성 및 안전성,3,0,0,3
구매 어려움,기타,0,3,0,3
출연진 정보,영화 및 문화,0,0,3,3
카드 할인,가격 및 할인,1,0,2,3
모바일 거치대 미제공,기타,0,3,0,3
"가격 890,000원",가격 및 상태,0,0,3,3
내구성 테스트 통과,제품 내구성 및 성능,3,0,0,3
저렴한 구매 방법,가격 및 구매,1,0,2,3
"가격 880,000원",제품 상태 및 가격,0,0,3,3
캠핑TV,기타,0,0,3,3
스탠바이미 GO 출시,신제품 및 모델,0,0,3,3
TV 없는 가정에서 유용,사용 환경 및 활용도,3,0,0,3
친절한 설치,사용자 경험 및 만족도,3,0,0,3
홈캠핑,기타,2,0,1,3
"가격 800,000 원",제품 구매 및 거래,0,0,3,3
품절 대란,사용자 경험 및 만족도,0,0,3,3
스탠바이미고 제공,기타,2,0,1,3
품절,구매 및 소비자 경험,0,2,1,3
모바일 기기 연결,기능 및 호환성,3,0,0,3
"가격 770,000원",가격 및 거래,0,0,3,3
스탠바이미 언급,기타,0,0,3,3
캠핑 1회 사용,제품 특징 및 사용,0,0,3,3
스탠드 형태,제품 기능 및 디자인,0,0,3,3
스탠바이미 거치대,기타,0,0,3,3
휴대성 강화,기타,2,0,1,3
홈 엔터테인먼트 혁신,제품 성능 및 기능,2,0,1,3
구매 결정,제품 구매 및 결정,0,0,3,3
새상품 미개봉,제품 상태 및 포장,0,0,3,3
27인치 모니터,기타,0,0,3,3
스탠바이미 가격,기타,0,2,1,3
거래 희망 지역 초평동,제품 구매 및 거래,0,0,3,3
HDMI 연결,제품 및 기술 사양,1,0,2,3
최저가 할인,제품 구매 및 가격,0,0,3,3
추천,기타,3,0,0,3
최저가 핫딜,기타,3,0,0,3
한정 판매,가격 및 거래,0,0,3,3
사용 편의성,기타,3,0,0,3
사용 횟수 적음,제품 특징 및 사용,0,0,3,3
터치 작동,사용 용도 및 기능,3,0,0,3
아이두젠 가방 포함,기타,0,0,3,3
예약중,기타,0,0,3,3
가격 경쟁력,제품 구매 및 경제성,3,0,0,3
넷플릭스 시청,사용자 경험 및 기능,1,0,2,3
스탠드형 TV,스탠드 및 설치 관련,0,0,3,3
무선 사용 시간,사용자 편의성 및 이동성,0,0,3,3
무료 설치,이동 및 설치,2,0,1,3
스탠바이미고 핫딜,제품 특징 및 기능,0,0,3,3
직거래 및 택배 거래 가능,거래 및 판매 관련,0,0,3,3
"가격 1,300,000원",가격 및 상태,0,0,3,3
LG 스탠바이미 경품,소비자 혜택 및 이벤트,0,0,3,3
LG 스탠바이미 고,기타,0,0,3,3
이동식 거치대,제품 기능 및 사용성,0,0,3,3
서촌 분위기 좋은 술집,라이프스타일 및 경험,3,0,0,3
"가격 1,150,000원",기타,0,0,3,3
구성품 포함,사용자 경험,1,0,2,3
LG 스탠바이미 관심,기타,2,0,1,3
"가격 500,000원",가격 및 거래 조건,0,0,3,3
"가격 1,100,000원",가격 및 렌탈,0,0,3,3
부산 직거래,구매 및 거래 위치,0,0,3,3
크기,기타,0,0,3,3
LG 스탠바이미 출시,브랜드 및 광고,0,0,3,3
스탠바이미 티비 핫딜,구매 및 거래,0,0,3,3
스펙 정보,기타,0,0,3,3
4개월 사용,기타,0,0,3,3
직거래 필요,거래 및 배송 관련,0,0,3,3
캠핑 수납가방 포함,사용자 경험,0,0,3,3
크기 큼,부가 정보 및 기타,0,2,1,3
대단한 제품,기타,3,0,0,3
화질 저하,기타,0,3,0,3
대구 직거래,거래 및 가격,0,0,3,3
화질 차이,기타,0,0,3,3
"거래 희망 지역: 공덕동, 연희동, 여의동",지역 및 거래 조건,0,0,3,3
제품 선택 고민,제품 비교 및 선택 고민,0,0,3,3
스탠바이미고 미개봉,제품 및 가격 정보,0,0,3,3
편리한 휴대성,사용 사례 및 추천,3,0,0,3
가방 필요,기타,0,0,3,3
액정 깨짐,제품 상태 및 문제,0,3,0,3
스탠바이미 선택,특정 사용자 및 활용 사례,1,0,2,3
연결 문제,기타,0,3,0,3
좋은 분위기,기타,3,0,0,3
세일,가격 및 거래,1,0,2,3
스탠바이미 선물,구매 및 소비,1,0,2,3
캠핑족에게 인기,라이프스타일 및 경험,3,0,0,3
"가격 30,000원",기타,0,0,3,3
특가 판매,가격 및 거래,0,0,3,3
스티븐 킹 원작,기타,0,0,3,3
액정 보호 필름,기타,0,0,3,3
제품 무게,디자인 및 크기,0,0,3,3
작은 화면,디자인 및 공간 활용,0,2,1,3
캠핑족 관심,캠핑 및 야외 사용,1,0,2,3
이동형 모니터,제품 및 기술 사양,1,0,2,3
캠핑족 겨냥,제품 활용 및 기능,0,0,3,3
중고 구매,가격 및 구매 옵션,0,0,3,3
영어 공부,사용 환경 및 편리성,0,0,3,3
스탠바이미 사용,기타,0,0,3,3
독특한 디자인,디자인 및 공간 활용,3,0,0,3
혁신적인 디자인,디자인 및 혁신,3,0,0,3
각도 조절 가능,스탠드 및 화면 조절,1,0,2,3
구성품,사용 용도 및 기능,0,0,3,3
공간 절약,제품 내구성 및 휴대성,2,0,1,3
스탠드,제품 디자인 및 기능,0,0,3,3
인터넷 연결 문제,제품 특징 및 활용,0,3,0,3
스탠바이미,기타,0,0,3,3
할인 특가 정보,가격 및 거래,0,0,3,3
가격대 있음,가격 및 구매,0,1,2,3
만족스러운 화질,기술 및 성능,3,0,0,3
다양한 용도 활용,기타,1,0,2,3
블루투스 스피커 활용,제품 기능 및 성능,2,0,1,3
다양한 연결 옵션,제품 성능 및 기능,2,0,1,3
인테리어 효과,디자인 및 스타일,3,0,0,3
로켓배송,배송 및 설치,2,0,1,3
터치 스크린,제품 활용 및 기능,1,0,2,3
금액에 대한 궁금증,가격 및 거래,0,0,3,3
간편함,사용 만족 및 편의성,3,0,0,3
32인치,제품 특징 및 구성,0,0,3,3
다양한 장소에서 사용 가능,사용 장소 및 활용,3,0,0,3
후기 좋음,사회 및 커뮤니티,3,0,0,3
매력적인 디자인,제품 디자인 및 기능,1,0,2,3
이용 규칙,기타,0,0,3,3
캠핑용 TV 추천,사용 사례 및 추천,3,0,0,3
테스트 사용,기타,0,0,3,3
가격 제안,제품 구매 및 경제성,0,0,3,3
기능 정보 필요,제품 기능 및 성능,0,0,3,3
거래 희망 지역: 논현1동,기타,0,0,3,3
미개봉/새제품,제품 상태 및 포장,0,0,3,3
미개봉 판매,거래 및 가격,0,0,3,3
2세대 출시 기대,기타,1,0,2,3
FHD 화질,제품 스펙 및 기능,0,0,3,3
영화 스탠 바이 미,영화 및 문학 관련,0,0,3,3
서울 중구 거래,지역 및 거래 조건,0,0,3,3
캠핑 티비,캠핑 및 휴대성,0,0,3,3
신제품 출시,마케팅 및 프로모션,0,0,3,3
밀리터리 스탠다드 테스트 통과,제품 기능 및 성능,3,0,0,3
캠핑용으로 좋음,캠핑 및 야외 활용,3,0,0,3
KB Pay 이벤트,소비자 혜택 및 이벤트,0,0,3,3
"거래방법: 직거래, 택배거래, 편의점픽업",거래 및 가격,0,0,3,3
분위기 좋음,라이프스타일 및 경험,3,0,0,3
이동 불편,사용자 경험,0,3,0,3
LG 스탠바이미고 경품,브랜드 및 인기,1,0,2,3
정상 작동,제품 성능 및 기능,3,0,0,3
핫한 제품,구매 및 소비자 반응,3,0,0,3
공식 카페 초대,제품 판매 및 혜택,0,0,3,3
만족스러운 사용,사용자 경험,3,0,0,3
거래방법: 택배거래,기타,0,0,3,3
만족스러운 제품,사용자 경험 및 만족도,3,0,0,3
할인 혜택,가격 및 구매,3,0,0,3
캠핑 티비 판매,캠핑 및 휴대성,0,0,2,2
택배 안심 거래 가능,거래 및 구매 방법,1,0,1,2
개인거래 판매,구매 및 거래,0,0,2,2
택배 조율 가능,기타,0,0,2,2
상품명: 스탠바이미 고,기타,0,0,2,2
캠핑 필수품,캠핑 및 야외활동,2,0,0,2
택배 착불,기타,0,0,2,2
캠핑 적합,캠핑 및 휴대성,1,0,1,2
캠핑 적합성 의문,사용 용도 및 적합성,0,2,0,2
견고한 내구성,기타,2,0,0,2
구매 의사,기타,2,0,0,2
개인거래 판매 완료,거래 및 판매 관련,0,0,2,2
캠핑 최적화,라이프스타일 적합성,2,0,0,2
수면 개선,편안함 및 건강,1,0,1,2
여행 및 캠핑 사용,사용 장소 및 활용,0,0,2,2
결제 방식,결제 및 구매 관련,0,0,2,2
쿠팡 판매 시작,구매 및 배송,0,0,2,2
구매 시기: 2023.09월,기타,0,0,2,2
서촌 데이트 장소,기타,2,0,0,2
캠핑티비,아웃도어 및 캠핑,0,0,2,2
크기 문제,기타,0,2,0,2
공간 부족,스탠바이미 제품,0,2,0,2
크기 애매함,사용 경험 및 평가,0,2,0,2
거의 새상품,사용 경험 및 후기,1,0,1,2
거의 새 상품,제품 상태 및 제조 정보,1,0,1,2
캠핑용품 구매,기타,0,0,2,2
거실에 TV 없음,기타,0,0,2,2
세팅 고민,기타,0,2,0,2
경품 당첨,프로모션 및 혜택,1,0,1,2
서울 직거래,구매 및 거래,0,0,2,2
영업시간 정보,기타,0,0,2,2
거실 인테리어,사용 환경 및 장소,0,0,2,2
거실 공간 부족,사용 용도 및 환경,0,0,2,2
경품 기회,마케팅 및 프로모션,2,0,0,2
크고 무거움,기타,0,1,1,2
거치대 필요,기타,0,0,2,2
캠핑퍼스트 회원 혜택,캠핑 및 휴대성,0,0,2,2
여가생활 향상,사용 경험 및 인기,2,0,0,2
세일 구매,가격 및 거래,1,0,1,2
고객직접설치,서비스 및 지원,0,0,2,2
캠핑족 인기,사용자 경험 및 리뷰,1,0,1,2
고급스러운 분위기,기타,2,0,0,2
선물로 받음,기타,1,0,1,2
세컨 티비로 괜찮음,구매 및 선택 고민,1,0,1,2
고속 무선 충전,제품 기능 및 연결성,2,0,0,2
쿠팡 안심케어 보험,제품 판매 및 혜택,0,0,2,2
캠핑장에서 실시간 드라마 시청,사용 환경 및 용도,0,0,2,2
선물 받음,추천 및 계획,0,0,2,2
선물 받은 제품,제품 구매 및 거래,0,0,2,2
퀄리티 좋음,기타,0,0,2,2
고중량 대형 TV 스탠드,제품 이동성 및 설치,0,0,2,2
캠핑장 사용,캠핑 및 야외활동,0,0,2,2
영어 학습 기회,기타,2,0,0,2
영화 감상,사용 사례 및 추천,0,0,2,2
캠핑용 제품,사용 장소 및 활용,0,0,2,2
예약구매,거래 및 판매 관련,0,0,2,2
캠핑에서 만족,제품 환영 및 만족,2,0,0,2
구매 가이드 필요,기타,0,0,2,2
새로운 출시,제품 선택 및 구매,0,0,2,2
거래 희망 지역 천호제2동,배송 및 지역,0,0,2,2
컴팩트한 크기,기타,2,0,0,2
거래 희망 지역 운정2동,거래 및 가격,0,0,2,2
거래 희망 지역 산동읍,제품 상태 및 거래,0,0,2,2
손잡이 디자인,디자인 및 편의성,0,0,2,2
구매 대기,가격 및 구매,0,0,2,2
여행 추천,기타,2,0,0,2
탁월한 음질,스피커 및 음질,2,0,0,2
"거래 희망 지역 논현1동, 삼성1동",기타,0,0,2,2
예약 구매,구매 및 판매 관련 이슈,0,0,2,2
새로운 경험 제공,사용자 경험 및 만족도,2,0,0,2
여행 시 사용,기타,2,0,0,2
구매 비용 부담,제품 구매 및 가격,0,2,0,2
구매 가이드,구매 및 사용 경험,0,0,2,2
소형 인버터 필요,사용 환경 및 설치,0,0,2,2
캠핑용 적합,캠핑 및 야외 활동,2,0,0,2
커스텀 케이스 포함,추가 기능 및 혜택,0,0,2,2
캠핑용 스탠바이미고,제품 활용 및 기능,0,0,2,2
공중파 방송 미지원,기타,0,1,1,2
거래방법 다양,거래 및 판매 관련,0,0,2,2
관람 포인트 공개,마케팅 및 이벤트,0,0,2,2
캠핑용 TV로의 적합성,캠핑 및 야외 사용,0,0,2,2
성능 관심,제품 기능 및 성능,0,0,2,2
에어플레이,기능 및 성능,0,0,2,2
거래 희망 지역: 장곡동,거래 및 판매,0,0,2,2
광고 많음,기타,0,2,0,2
영화 정보,영화 관련,0,0,2,2
캠핑에서 편리함,제품 활용 및 기능,2,0,0,2
캠핑에서 편리,기타,2,0,0,2
캠핑에서 테이블 문제,사용 환경 및 용도,0,2,0,2
영화 후기,영화 및 콘텐츠,0,0,2,2
거래 희망 지역 화곡제1동,제품 구매 및 거래,0,0,2,2
성능 궁금,제품 기능 및 성능,0,0,2,2
최고의 아이템,제품 환영 및 만족,2,0,0,2
상품명: LG 스탠바이미고,제품 구매 및 거래,0,0,2,2
제품 판매 완료,제품 상태 및 사용,0,0,2,2
방전 문제,제품 상태 및 문제,0,2,0,2
제품 정보 공유,사용 경험 및 후기,0,0,2,2
배경화면 저장,기타,0,0,2,2
제품 크기,디자인 및 크기,0,0,2,2
배송 기대,배송 및 수령,1,0,1,2
배송 및 후기 고려,기타 기능 및 옵션,0,0,2,2
배송 완료,기타,0,0,2,2
구매처 고민,기타,0,0,2,2
제품명,제품 정보 및 출시,0,0,2,2
제품명: 스탠바이미,기타,0,0,2,2
뛰어난 활용성,기능 및 성능,2,0,0,2
제휴카드 할인,구매 및 가격 혜택,2,0,0,2
조립 및 설치 불필요,디자인 및 편의성,1,0,1,2
조립 용이,사용 경험,2,0,0,2
렌탈 추천,특정 사용자 및 활용 사례,2,0,0,2
인기 상승,구매 및 소비자 경험,2,0,0,2
제품 스펙,제품 선택 및 구매,0,0,2,2
제품 소개,기타,0,0,2,2
제품 성능 궁금증,기타,0,0,2,2
인기 상품,기타,2,0,0,2
제품 선택,제품 선택 및 구매,0,0,2,2
제품 상태 좋음,제품 상태 및 신뢰성,2,0,0,2
방문 설치 가능,제품 설치 및 사용,0,0,2,2
제품 사용 후기,사용 경험 및 후기,0,0,2,2
룸앤티비 가격,가격 및 거래,0,0,2,2
받침대 문제,사용 경험 및 평가,0,2,0,2
제품 보호,보호 및 내구성,0,0,2,2
룸투룸쉐어,제품 기능 및 연결성,1,0,1,2
제품 도착,고객 서비스 및 지원,0,0,2,2
리모컨,기타,0,0,2,2
제품 기능에 대한 궁금증,제품 기능 및 사용,0,0,2,2
배터리 방전 문제,기타,0,2,0,2
조용한 분위기,기타,2,0,0,2
조용한 인버터 컴프레서,제품 품질 및 디자인,2,0,0,2
돌비 애트모스,제품 기능 및 기술,1,0,1,2
더 큰 화면에서 콘텐츠 즐김,제품 디자인 및 기능,1,0,1,2
보호필름 필요성,제품 기능 및 사용성,0,0,2,2
이동식 동반자,사용 용도 및 환경,2,0,0,2
이동식 스마트 TV,제품 크기 및 이동성,0,0,2,2
즐거운 시청 경험,기타,2,0,0,2
보관 용이,사용자 편의 및 기능,2,0,0,2
보관 및 휴대 가능,휴대성과 보관,0,0,2,2
중고나라 자동 노출,마케팅 및 커뮤니티 반응,0,0,2,2
중고나라 앱 존재,기타,0,0,2,2
별도 스탠드 구매 가능,기타,0,0,2,2
변우석 모델 발탁,제품 인지도 및 광고,1,0,1,2
주차 불가,사회 및 커뮤니티,0,1,1,2
변우석 관련 콘텐츠,사용자 경험 및 만족도,0,0,2,2
돌비 사운드,사운드 및 스피커,0,0,2,2
이동형 스탠드 타입,제품 디자인 및 이동성,0,0,2,2
배터리 수명,기타,1,0,1,2
이동형 엔터테인먼트,캠핑 및 외부 활용,0,0,2,2
좋은 퀄리티,기타,1,0,1,2
번거로움 감소,기타,2,0,0,2
좋은 스피커,스피커 및 음질,2,0,0,2
좋은 성능,제품의 장점 및 추천,2,0,0,2
드라마 시청,제품 사용 경험,0,0,2,2
득템,프로모션 및 이벤트,2,0,0,2
이벤트 진행,브랜드 및 인기,0,0,2,2
좋은 가격,가격 및 구매 고려,2,0,0,2
이벤트 참여 열기,이벤트 및 혜택,2,0,0,2
이벤트 참여 유도,마케팅 및 프로모션,0,0,2,2
디스플레이 각도 조절 가능,기능 및 기술,2,0,0,2
배터리 잔량,제품 특징 및 활용,0,0,2,2
배터리 시간 3시간,제품 스펙 및 기능,0,0,2,2
박스 보유,제품 상태 및 거래 조건,0,0,2,2
제품 교환,사용자 경험 및 평가,0,0,2,2
제품 가격,가격 및 구매,0,0,2,2
모바일 최적화,제품 기능 및 성능,1,0,1,2
모니터 회전 가능,제품 특성 및 기능,0,0,2,2
물량 확보,시장 및 소비자 반응,0,0,2,2
저반사 지문방지,기술 및 성능,0,0,2,2
자가설치 가능,사용 및 설치 편리성,0,0,2,2
무이자 할부,가격 및 거래 조건,2,0,0,2
무이자 구매,구매 및 가격 관련,0,0,2,2
저렴한 구매 정보,구매 및 경제성,0,0,2,2
모바일 기기 미러링,기능 및 기술,1,0,1,2
저렴한 TV,기능 및 성능,0,0,2,2
모바일 기기 사용,기타,0,0,2,2
모바일 기기 화면 미러링,제품 및 기능,1,0,1,2
재즈 음악 재생,기타,0,0,2,2
모바일 버전,기타,0,0,2,2
모바일 상품권 지급,이벤트 및 혜택,0,0,2,2
모바일 쿠폰 증정,이벤트 및 혜택,0,0,2,2
미개봉 상품 판매,제품 상태 및 판매,0,0,2,2
재고 부족,구매 및 가격,0,2,0,2
무선 기능,디자인 및 혁신,1,0,1,2
무선 가능,기타,2,0,0,2
장점,사용자 경험 및 만족도,0,0,2,2
모바일 화면 미러링,제품 성능 및 기능,1,0,1,2
모션데스크 개발 및 공급,기타,0,0,2,2
무거운 무게,기타,0,2,0,2
잘산템,구매 및 소비,2,0,0,2
무겁지 않음,휴대성과 이동성,2,0,0,2
무료배달 및 설치,제품 구매 및 거래,2,0,0,2
무게 17.5kg,기타,0,0,2,2
무게 있음,기타,0,1,1,2
무게감,기타,0,1,1,2
작은 크기,제품 특징 및 사용성,0,0,2,2
모니터 품질,화질 및 디스플레이,0,0,2,2
미개봉 새 상품,제품 상태 및 가격,2,0,0,2
제주도 촬영,광고 및 홍보,0,0,2,2
미사용 신품,제품 상태 및 사용,1,0,1,2
리모컨 수납방법,제품 특징 및 활용,0,0,2,2
제조일자,기타 제품 및 서비스,0,0,2,2
바퀴로 이동 용이,이동 및 사용 편의성,2,0,0,2
제조년월 24년 2월,제품 상태 및 제조 정보,0,0,2,2
인천 주안 거래,거래 및 가격,0,0,2,2
리버피닉스 특별전 스탠바이미 뱃지,기타,0,0,2,2
인체공학적 디자인,제품 기능 및 디자인,2,0,0,2
인체공학적 설계,기능 및 성능,0,0,2,2
인터넷 가입,기타,0,0,2,2
정품 판매,서비스 및 지원,0,0,2,2
정품,기타,0,0,2,2
마이테이블 크기 의문,기타,0,0,2,2
정수기 필요 없음,구매 및 선택 고민,0,0,2,2
미사용품,사용 경험 및 후기,0,0,2,2
정기구독 이벤트,소비자 혜택 및 이벤트,0,0,2,2
미개봉 새 제품,제품 상태 및 신뢰성,0,0,2,2
말머리 선택 필요,사용자 경험,0,0,2,2
정교함과 완성도,기타,2,0,0,2
미러링 서비스,기능 및 사용성,2,0,0,2
절약 방법 안내,제품 구매 및 경제성,0,0,2,2
일반 버전 가격,가격 및 거래,0,0,2,2
전자칠판,기타,0,0,2,2
일본 박스오피스 5주 연속 1위,영화 관련,2,0,0,2
머스트해브 가전,사용 경험 및 후기,2,0,0,2
미니 리모컨,사용 및 설치 편리성,0,0,2,2
멋진 제품,마음의 만족,2,0,0,2
미개봉 신제품,한정판 및 기념품,0,0,2,2
전용 가방 포함,구성품 및 부속품,0,0,2,2
일요일 영업,기타,2,0,0,2
미개봉 새상품 판매,제품 구매 및 거래,0,0,2,2
지상파 방송 시청,기타,0,0,2,2
댓글 이벤트,마케팅 및 커뮤니티 반응,0,0,2,2
부드러운 이동,제품 기능 및 디자인,2,0,0,2
사용할 일 없음,기타,0,0,2,2
우수한 화질,제품 특성 및 기능,2,0,0,2
나사 문제,기타,0,2,0,2
우유 정기배송,기타,0,0,2,2
친절한 서비스,서비스 및 지원,2,0,0,2
운동 시 사용,기타,2,0,0,2
운영 시간,운영 및 환경,0,0,2,2
충전식,제품 성능 및 기능,0,0,2,2
충전독용 보관함,제품 특성 및 기능,0,0,2,2
내구성 테스트 기준 충족,제품 내구성 및 성능,2,0,0,2
내장 게임,기능 및 성능,2,0,0,2
사은품으로 받은 제품,기타,0,0,2,2
충동구매,제품 상태 및 관리,0,0,2,2
내장 스탠드,디자인 및 편의성,0,0,2,2
넓은 화면,화질 및 화면,2,0,0,2
네이버페이 결제,거래 및 가격,0,0,2,2
깔끔한 외관,기타,2,0,0,2
추천 제품,기타,1,0,1,2
추천 요청,기타,0,0,2,2
웹브라우저,제품 기능 및 연결성,0,0,2,2
추가 할인,프로모션 및 이벤트,1,0,1,2
넷플릭스 시청 기대,기타,1,0,1,2
추가 구매,구매 및 이벤트,0,0,2,2
사용감 있음,기타,0,0,2,2
사용감 없음,제품 상태 및 거래,2,0,0,2
노래방 기능,사용자 경험 및 기능,2,0,0,2
노래방 마이크,멀티미디어 기능,0,0,2,2
위치 정보 제공,기타,0,0,2,2
위치 편리,기타,2,0,0,2
사용 이상 없음,제품 상태 및 사용,2,0,0,2
최저가 구매 가능,구매 및 가격,2,0,0,2
침대에서 시청,제품 기능 및 사용성,1,0,1,2
삼성 룸앤티비,기타,0,0,2,2
높은 관심,기타,2,0,0,2
상품 비교,제품 정보 및 추천,0,0,2,2
오래된 폰 사용,기타,0,0,2,2
구매처 추천,가격 및 거래,0,0,2,2
캠핑 유튜버 사용기,사용 경험 및 후기,0,0,2,2
캠핑 용품,기타,0,0,2,2
캠핑 용도,사용 용도 및 적합성,1,0,1,2
구성품 만족,사용 및 설치 편리성,2,0,0,2
캠핑 욕구,사용 환경 및 용도,0,0,2,2
구성품 본품+충전기,제품 구성 및 특성,0,0,2,2
캠핑 시즌 적합,캠핑 및 야외 활용,1,0,1,2
캠핑 시즌,캠핑 및 야외 활동,0,0,2,2
상품권 행사,제품 구매 및 가격,0,0,2,2
캠핑 사용 가능,캠핑 및 야외 활동,2,0,0,2
국내 미개봉,영화 및 문화,0,0,2,2
캠핑 및 홈캠핑 사용,캠핑 및 야외 활동,0,0,2,2
기능 정보,제품 정보 및 추천,0,0,2,2
침실에서 사용,사용 환경 및 목적,1,0,1,2
캠핑 기대,사용 환경 및 용도,2,0,0,2
캠핑 관련,캠핑 및 야외 활동,0,0,2,2
캠핑 감성템,사용 환경 및 활용,0,0,2,2
캠핑 TV,사용 환경 및 용도,0,0,2,2
기본 설치 포함,기타,2,0,0,2
캠핑 2회 사용,제품 상태 및 관리,0,0,2,2
완전 미개봉 제품,제품 구매 및 거래,0,0,2,2
완판,기타,2,0,0,2
캐시백 혜택,이벤트 및 혜택,2,0,0,2
기스 없음,가격 및 상태,2,0,0,2
캐리백 형태,제품 디자인 및 이동성,0,0,2,2
카카오 결제 할인,제품 판매 및 혜택,2,0,0,2
용도 불일치,사용 경험 및 후기,0,1,1,2
긴 제작 대기 시간,디자인 및 개인화,0,1,1,2
사용 예정 없음,구매 및 판매 관련 이슈,0,0,2,2
높은 만족도,제품 만족도 및 인기,2,0,0,2
이동식 TV 모니터,기타,0,0,2,2
다양한 활용 가능,기타 기능 및 특징,2,0,0,2
차박용 사용,사용 경험 및 후기,0,0,2,2
다양한 선물 옵션,제품 기대 및 스펙,1,0,1,2
블루투스 연결,제품 기능 및 사용성,1,0,1,2
다양한 연결 가능,연결 및 호환성,1,0,1,2
다양한 연결 가능성,제품 기능 및 연결성,0,0,2,2
차박 및 캠핑족 적합,캠핑 및 외부 활동,1,0,1,2
차박,사용 환경 및 용도,0,0,2,2
다양한 자막 지원,사용자 편의 및 기능,2,0,0,2
블랙 스탠드,디자인 및 공간 활용,0,0,2,2
브랜드 비교,제품 비교 및 구매 고려,0,0,2,2
이동 가능한 TV,이동 및 설치 용이성,0,0,2,2
집에서 사용 애매함,사용 환경 및 설치,0,2,0,2
다양한 화면 모드,제품 기능 및 성능,2,0,0,2
집에서 사용 가능,이동식 스마트 TV,1,0,1,2
다양한 활용 가능성,사용 및 활용,1,0,1,2
차별화된 무빙스탠드 디자인,기타,0,0,2,2
불안정한 적재,설치 및 이동성,0,2,0,2
이동 수월,기타,2,0,0,2
집들이 선물,기타,1,0,1,2
불멍,라이프스타일 및 경험,1,0,1,2
이동 중 영상 시청,기타,2,0,0,2
단점,사용자 경험 및 만족도,0,0,2,2
직접 설치 서비스,기타,2,0,0,2
직접 배송,기타,2,0,0,2
당첨자 발표,브랜드 및 이벤트,0,0,2,2
대구 영주 거래 가능,거래 및 지역 관련,0,0,2,2
대만족,기타,2,0,0,2
이동성 강조,제품 휴대성과 이동성,1,0,1,2
이동식,스탠바이미 제품,1,0,1,2
부산 사하구 직거래,거래 및 가격,0,0,2,2
다양한 사용 방법,다양한 기능 및 설정,2,0,0,2
착한 가격,가격 및 구매,2,0,0,2
최신 트렌드 가전,기타,0,0,2,2
초기 구매,제품 구매 및 결정,0,0,2,2
사용 빈도 적음,기타,0,0,2,2
높은 판매량,구매 및 소비자 반응,2,0,0,2
최신 모델,기타,0,0,2,2
사용 빈도 낮음,제품 사용 경험 및 평가,0,0,2,2
사용 만족,사용 만족 및 편의성,2,0,0,2
최근 생산 시리얼,기타,0,0,2,2
터치 가능,제품 기능 및 사용성,1,0,1,2
최고 제품 선정,기타,2,0,0,2
사기 경험,기타,0,2,0,2
초캠장터 이용규칙,기타,0,0,2,2
사기,기타,0,2,0,2
유용성,기타,2,0,0,2
눈에 띄는 제품,기타,2,0,0,2
유용한 제품,제품의 장점 및 추천,2,0,0,2
닌텐도 스위치 연결 가능,제품 스펙 및 기능,2,0,0,2
음성 인식,기능 및 성능,0,0,2,2
닌텐도 연결,기타,1,0,1,2
닌텐도 연결 가능,제품 특성 및 기능,0,0,2,2
유튜브,기타,0,0,2,2
빠른 배송 및 설치,이동 및 설치 용이성,2,0,0,2
체험단 모집 이벤트,브랜드 및 이벤트,0,0,2,2
체험 가능,특별한 경험 및 기능,1,0,1,2
유튜브 및 넷플릭스 시청 가능,사용 환경 및 편리성,0,0,2,2
유튜브 사용,기타,0,0,2,2
첨단 기술,제품 사용 및 기능,2,0,0,2
빔프로젝터 장점,기타,0,0,2,2
다양한 경품,추가 서비스 및 경품,1,0,1,2
다양한 경품 제공,이벤트 및 혜택,2,0,0,2
챔피언스 에디션 가격,가격 및 거래,0,0,2,2
융통성,기타,1,0,1,2
탭 연결 가능,플랫폼 및 기술 지원,2,0,0,2
고급스러움,라이프스타일 및 경험,2,0,0,2
개인 거래 판매,제품 상태 및 거래,0,0,2,2
프라이빗한 스크린,디자인 및 혁신,2,0,0,2
스탠바이미 Go 출시,기타,0,0,2,2
TV 기능,제품 기능 및 성능,0,0,2,2
TV 기능 없음,기타,0,0,2,2
스탠바이미 Go 제공,이동 및 설치,0,0,2,2
TV 대체 가능성,기능 및 사용,0,0,2,2
프레딧 정기구독 이벤트,마케팅 및 이벤트,1,0,1,2
TV 미시청자,기타,0,0,2,2
TV 미시청자 추천,기타,2,0,0,2
TV 미시청자에게 적합,제품 설치 및 사용 환경,1,0,1,2
프레딧 적립금,이벤트 및 혜택,0,0,2,2
프레딧 이벤트,마케팅 및 이벤트,1,0,1,2
아쉬움,기타,0,2,0,2
실제 사용기 궁금,제품 사용 경험 및 평가,0,0,2,2
스탠바이미 Go TV 리뷰,리뷰 및 체험,0,0,2,2
TV 시청,기타,0,0,2,2
TV 없는 가정,사용 환경 및 용도,0,0,2,2
풍부한 사운드,음향 및 사운드,2,0,0,2
TV 없는 거실,기타,1,0,1,2
TV 없는 집에서 사용,특정 사용자 및 활용 사례,1,0,1,2
품질 검증,브랜드 및 신뢰도,2,0,0,2
풀박스,기타,0,0,2,2
TV 추가 구매 고민,구매 및 거래,0,0,2,2
아이 패드 대신 TV 시청 가능,기타,2,0,0,2
TV로 사용 가능,기타 기능 및 특징,1,0,1,2
필름 부착,제품 특성 및 용도,0,0,2,2
실용적인 기능,사용자 편의 및 기능,2,0,0,2
가로 및 세로 모드 가능,기타,0,0,2,2
한정적인 상황에서 사용,기타,0,0,2,2
할인 품목 제한,제품 상태 및 가격,0,1,1,2
할인 추천,가격 및 거래,2,0,0,2
할인 제공,구매 및 할인,2,0,0,2
할인 정보 제공,가격 및 거래,0,0,2,2
스탠바이미 구매 결정,기타,0,0,2,2
할인 없음,가격 및 구매,0,0,2,2
할인 기회,구매 과정,2,0,0,2
LG전자 FHD LED,기타,0,0,2,2
스탠바이미 고려,구매 고려 및 비교,0,0,2,2
한정판 제품,한정판 및 기념품,0,0,2,2
LG전자 공식인증,브랜드 및 이벤트,0,0,2,2
한정 수량,구성 및 설치,0,0,2,2
실외 사용 가능,기타,1,0,1,2
스탠바이미 고 제품,기타,0,0,2,2
신혼집 필수템,구매 및 소비,2,0,0,2
스탠바이미 고 기획,제품 출시 및 리뷰,0,0,2,2
MZ세대 공략,기타,0,0,2,2
NFC 기능으로 미러링,제품 디자인 및 기능,1,0,1,2
NFC 미러링 기능,기능 및 성능,1,0,1,2
OTT 및 인터넷 사용,사용 환경 및 목적,0,0,2,2
OTT 서비스,사용자 경험 및 기능,1,0,1,2
스탠바이미 경품,마케팅 및 프로모션,1,0,1,2
스탠바이미 가격 비쌈,제품 및 브랜드 인식,0,2,0,2
실사용 시간 1시간 미만,제품 상태 및 문제,0,0,2,2
폰 사용 중 미러링 불가,부정적 평가,0,2,0,2
아이두젠 케이스 불만족,기타,0,2,0,2
UHD 4K,기타,0,0,2,2
안전 결제 가능,제품 구매 및 거래,0,0,2,2
가격 괜찮음,거래 및 가격,2,0,0,2
안방 사용,제품 설치 및 사용 환경,0,0,2,2
가격 대비 성능,가성비 및 가격,2,0,0,2
스탠드/거치대 선택 어려움,기타 기능 및 옵션,0,2,0,2
스탠드 형태 사용,사용 및 설치 편리성,0,0,2,2
가격 문의,구매 및 가격 관련,0,0,2,2
가격 문제,가격 및 거래,0,2,0,2
스탠드 포함,기타,0,0,2,2
가격 변동 가능성,가격 및 상태,0,0,2,2
패밀리 세팅,기타,1,0,1,2
안성맞춤 사이즈,사용자 경험 및 만족도,2,0,0,2
안전 보관,구매 및 거래,0,0,2,2
USB 카메라 호환,플랫폼 및 기술 지원,1,0,1,2
팝업스토어 구매,구매 및 이벤트,0,0,2,2
팝업스토어,기타,0,0,2,2
가격 정보 제공,가격 및 결제 옵션,0,0,2,2
가격 협상 불가,제품 상태 및 거래,0,0,2,2
판매지역 용인 수지,구매 및 거래,0,0,2,2
"가격: 650,000 원",가격 및 비용,0,0,2,2
"가격: 850,000 원",기타,0,0,2,2
스탠드 높이 18cm,제품 스펙 및 기능,0,0,2,2
가격대,기타,0,1,1,2
판매 의도,제품 상태 및 거래,0,0,2,2
스탠 바이 미 영화 정보,영화 및 문화,0,0,2,2
편리한 기능,제품 사용 및 기능,2,0,0,2
"가격 930,000원",가격 및 상태,0,0,2,2
"가격 890,000 원",구매 및 가격 관련,0,0,2,2
"가격 850,000 원",가격 및 비용,0,0,2,2
포터블 모니터,기타,0,0,2,2
아이들이 TV 시청,사용 경험 및 후기,2,0,0,2
아이에게 인기,제품 사용 경험,2,0,0,2
webOS,기능 및 성능,0,0,2,2
"가격 1,020,000원",제품 구매 및 가격,0,0,2,2
편안한 수면,편안함 및 건강,2,0,0,2
"가격 1,170,000원",제품 구매 및 가격,0,0,2,2
"가격 1,200,000원",제품 구매 및 가격,0,0,2,2
"가격 1,280,000원",가격 및 거래,0,0,2,2
아이폰 미러링 가능 여부,제품 기능 및 사용,0,0,2,2
"가격 20,000원",기타,0,0,2,2
스탠드형 제공,공간 활용 및 설치,0,0,2,2
"가격 350,000원",가격 및 구매,0,0,2,2
편리한 이동식 엔터테인먼트,기능 및 사용,0,0,2,2
편리한 이동성,기타,2,0,0,2
"가격 670,000원",가격 및 거래 조건,0,0,2,2
편리한 시청,기타,2,0,0,2
스탠드형 사용,인테리어 및 디자인,0,0,2,2
"가격 720,000원",가격 및 거래,0,0,2,2
"가격 740,000원",제품 상태 및 가격,0,0,2,2
가격 75만원,가격 및 거래,0,0,2,2
"가격 760,000원",제품 및 가격 정보,0,0,2,2
편리한 리모컨,제품 기능 및 사용성,2,0,0,2
할인 프로모션,가격 및 프로모션,1,0,1,2
LG 우승 한정판,제품 특징 및 사용,0,0,2,2
스탠바이미 구매 욕구,제품 기대 및 스펙,1,0,1,2
3D에 어울리는 콘텐츠,기타,2,0,0,2
27인치 스마트모니터,기타,0,0,2,2
27인치 터치 스크린,기타,0,0,2,2
27인치 화면,기타,0,0,2,2
휴대 가능한 엔터테인먼트 센터,제품 적합성 및 사용 장소,2,0,0,2
휴가 사용 만족,사용 및 활용,2,0,0,2
2세대 제품,기타,0,0,2,2
스탠바이미GO,제품 특징 및 사용,0,0,2,2
스탠바이미2세대,기타,0,0,2,2
후속 모델,제품 출시 및 인지도,0,0,2,2
후기,기타,0,0,2,2
회원 의견 반영,기타,0,0,2,2
3시간 무선 재생시간,기타,2,0,0,2
스탠바이미 전용 커버,제품 및 액세서리,0,0,2,2
4K 지원,기능 및 성능,0,0,2,2
화질 만족,기능 및 사용,2,0,0,2
스탠바이미 티비 특가,기타,0,0,2,2
5회 미만 사용,기타,0,0,2,2
600만 관객 동원,영화 관련,2,0,0,2
60Hz 주사율,제품 스펙 및 기술,0,0,2,2
화면 크기 다양,기타,0,0,2,2
화면 조절 가능,기타,2,0,0,2
8단 높이 조절,제품 기능 및 연결성,2,0,0,2
화면 사이즈,제품 특징 및 활용,0,0,2,2
스탠바이미 정보 제공,제품 정보 및 추천,0,0,2,2
휴대성 뛰어남,기타,2,0,0,2
스탠바이미고 챔피언에디션,기타,0,0,2,2
휴대용,이동성과 휴대성,1,0,1,2
휴대용 27인치 모니터 추천,이동성과 휴대성,1,0,1,2
스탠바이미고 상품 정보,제품 및 모델 비교,0,0,2,2
힐링쉴드 AG 저반사 지문방지 필름,기타,0,0,2,2
스탠바이미고 설치,이동 및 설치,0,0,2,2
스탠바이미고 구입,구매 및 경제성,0,0,2,2
스탠바이미고 구매 희망,제품 비교 및 선택,0,0,2,2
스탠바이미고 구매 고민,제품 특성 및 용도,0,0,2,2
스탠바이미고 구매 고려,구매 고려 및 비교,0,0,2,2
스탠바이미고 관심,제품 및 모델 비교,1,0,1,2
희망 거래 지역,거래 및 배송 관련,0,0,2,2
희망 가격 75만원,가격 및 거래,0,0,2,2
1인 가구에 적합,라이프스타일 적합성,0,0,2,2
스탠바이미고 가방,이동성과 휴대성,0,0,2,2
스탠바이미고 가격 비쌈,추천 및 계획,0,2,0,2
1회 사용,제품 상태 및 관리,0,0,2,2
스탠바이미고 가격,가격 및 구매 옵션,0,0,2,2
스탠바이미고 2세대 출시,제품 혁신 및 신제품,1,0,1,2
스탠바이미go 특가,기타,0,0,2,2
스탠바이미고 제품,제품 모델 및 출시,0,0,2,2
휴대용 소형 포터블 티비,기타,0,0,2,2
휴대용 소형 포터블,캠핑 및 휴대성,0,0,2,2
휴대용 사용 편리,제품 활용 및 기능,2,0,0,2
스탠바이미go 정보 제공,스탠바이미 제품 관련,0,0,2,2
24인치,기타,0,0,2,2
스펙 및 성능,제품 비교 및 구매 고려,0,0,2,2
Apple TV 앱 연동,기타,2,0,0,2
핫딜 가격,제품 판매 및 혜택,2,0,0,2
스탠바이미 디스플레이,화질 및 디스플레이,0,0,2,2
신개념 포터블 스크린,기타,0,0,2,2
스탠바이미 모델 변우석,제품 인지도 및 광고,0,0,2,2
LG 스탠바이미 고 출시,제품 출시 및 관심,0,0,2,2
신기한 디자인,기타,2,0,0,2
스탠바이미 렌탈 핫딜,구매 및 판매 정보,0,0,2,2
스탠바이미 렌탈 서비스,렌탈 및 구독 서비스,0,0,2,2
신기한 제품,제품 구매 및 기대,2,0,0,2
LG 스탠바이미 구입,제품 구매 및 만족도,0,0,2,2
LG 스탠바이미 렌탈 론칭,제품 출시 및 트렌드,0,0,2,2
신뢰할 수 있는 후기,기타,2,0,0,2
스탠바이미 디자인,제품 디자인 및 이동성,1,0,1,2
스탠바이미 득템,제품 구매 및 기대,1,0,1,2
스포츠 알람,제품 기능 및 연결성,0,0,2,2
LG 스탠바이미 선택,기타,2,0,0,2
LG 스탠바이미 이벤트,마케팅 및 이벤트,0,0,2,2
LG 스탠바이미 인기,인기 및 시장 반응,0,0,2,2
LG 스탠바이미 정보 제공,기타,0,0,2,2
해상도 FHD,화질 및 디스플레이,0,0,2,2
LG 스탠바이미GO,제품 출시 및 이벤트,0,0,2,2
LG 스탠바이미go LG트윈스 챔피언 에디션,기타,0,0,2,2
핫딜 중,기타,0,0,2,2
핫딜 정보 제공,기타,0,0,2,2
스탠바이미 구입 고려,구매 고려 및 비교,0,0,2,2
LG 스탠바이미고 판매,제품 특성 및 용도,0,0,2,2
스탠바이미 미개봉 새제품,기타,0,0,2,2
헤드폰 대세,기타,0,0,2,2
LG 스탠바이미 Go 출시,제품 혁신 및 신제품,0,0,2,2
LG 스탠바이미 Go 경품,기타,1,0,1,2
화면,기타,0,0,2,2
스피커 위치,기타,0,0,2,2
홈 엔터테인먼트,제품 특성 및 기능,1,0,1,2
HDMI 포트,기능 및 성능,0,0,2,2
HDMI/USB 연결 가능,제품 기능 및 연결성,0,0,2,2
스피커 포함,기타,0,0,2,2
스탠바이미 스피커,기타,0,0,2,2
스피킹 실력 향상,기타,2,0,0,2
LED 스탠바이미 Go TV,기타,0,0,2,2
호환성,제품 호환 및 액세서리,0,0,2,2
호환 액정 보호 필름,구성 및 설치,0,0,2,2
스탠바이미 선호,스탠바이미 및 스마트 모니터 관련,0,0,2,2
LG ThinQ 앱 활용,기타,1,0,1,2
혜택 할인,렌탈 및 구독 서비스,1,0,1,2
혜택,기타,1,0,1,2
스탠바이미 상품 정보,기타,0,0,2,2
LG 서비스센터 방문,서비스 및 지원,0,0,2,2
혁신적인 제품,제품 혁신 및 신제품,2,0,0,2
혁신적인 생활 편의 시스템,제품 사용 및 기능,2,0,0,2
식사시간 시청,기타,2,0,0,2
혁신적인 기술력,디자인 및 혁신,2,0,0,2
스탠바이미 부러움,기타 제품 및 서비스,0,0,2,2
혁신적,제품 성능 및 기능,1,0,1,2
판매 가격,거래 및 가격,0,0,2,2
스탠바이미 고 관심,시장 반응 및 인기,0,0,2,2
가벼움,사용 및 설치,2,0,0,2
간단한 참여 방법,마케팅 및 프로모션,2,0,0,2
쉬운 조립,편의성과 활용,2,0,0,2
특가 행사,기타,0,0,2,2
가전구독 서비스,기타,0,0,2,2
스마트폰 화면 미러링,사용자 편의 및 기능,2,0,0,2
특별 혜택,구매 및 가격 혜택,1,0,1,2
테이블모드,기타,0,0,2,2
간편한 스마트폰 미러링,제품 디자인 및 기능,2,0,0,2
터치 사용 편리,사용 편의성,2,0,0,2
터치식,사용자 편의 및 기능,2,0,0,2
티몬 무이자 할부,구매 옵션 및 서비스,0,0,2,2
특가 정보 제공,기타,0,0,2,2
테이블 필요,기타,0,1,1,2
간편한 사용,기능 및 사용 편의성,2,0,0,2
강력한 기능,제품 성능 및 기능,2,0,0,2
스마트 디스플레이,제품 성능 및 기능,0,0,2,2
티저 예고편 공개,제품 기대 및 스펙,0,0,2,2
테이블 모드 특화,기타,2,0,0,2
스마트 모니터,기타,0,0,2,2
티빙 라이브는 폰만 가능,기타,0,2,0,2
감독 롭 라이너,기타,0,0,2,2
야외 활동 적합,기타,1,0,1,2
터치 조작,기타,1,0,1,2
터치 미지원,기능 및 성능,0,2,0,2
각도 조절,사용 경험,1,0,1,2
가성비 고민,제품 비교 및 선택,0,0,2,2
터치스크린 기능,기능 및 성능,1,0,1,2
감성,사용자 경험 및 만족도,0,0,2,2
스크린 각도 조절,기타,1,0,1,2
특가 구매 가능,구매 및 사용 경험,1,0,1,2
트윈스 로고 및 월페이퍼,기타,0,0,2,2
파손 염려,제품 상태 및 포장,0,2,0,2
이동형 스탠드,제품 특성 및 기능,0,0,1,1
시공초월 타입슬립 어드벤처,기타,0,0,1,1
야외행사 및 캠핑장에서 사용 가능,캠핑 및 야외활동,1,0,0,1
이벤트 중복참여 가능,구매 및 가격 혜택,0,0,1,1
에어플레이 설명,기타,0,0,1,1
에어플레이 기능 활용,제품 사용 및 기능,0,0,1,1
이벤트 참여 방법,프로모션 및 이벤트,0,0,1,1
이벤트 증정,이벤트 및 프로모션,0,0,1,1
시간가는줄 모름,편리한 조작 및 사용자 경험,1,0,0,1
시간의 구분,기타,0,0,1,1
식사 공간 침해,공간 및 휴대성 문제,0,1,0,1
슬픔,기타,0,1,0,1
이벤트 참여기간,브랜드 및 이벤트,0,0,1,1
식사 시 TV 시청 불편,기타,0,1,0,1
이벤트 페이지,기타,0,0,1,1
식사 종류 한정적,기타,0,1,0,1
이벤트성 영상,기타,0,0,1,1
스피킹 자신감,기타,0,0,1,1
야외활동 시 TV 사용,사용 경험 및 후기,1,0,0,1
이사 다니기 편리한 TV 필요,사용 및 설치 환경,0,0,1,1
이동형 스크린,기타,0,0,1,1
스피커채널 4.0ch,플랫폼 및 기술 지원,0,0,1,1
시그니처 라인 존재,기타,0,0,1,1
이벤트 중,기타,0,0,1,1
이벤트 중복 참여 가능,프로모션 및 이벤트,0,0,1,1
시댁에서 사용,기타,1,0,0,1
시장조사,기타,0,0,1,1
시스루컷 추천,디자인 및 외관,1,0,0,1
이벤트 경품 신청 기회,이벤트 및 경품,1,0,0,1
시리즈 역대 최고,기타,1,0,0,1
이벤트 공유,구매 및 이벤트,0,0,1,1
시리즈 사상 최고 관객 수 기록,제품 특성 및 기능,1,0,0,1
이미지 첨부 필수,기타 이슈 및 요구,0,0,1,1
이벤트 구매 의향,가격 및 구매 정보,0,0,1,1
시력 보호,건강 및 생활,1,0,0,1
이벤트 기간,이벤트 및 프로모션,0,0,1,1
이벤트 기대감,이벤트 및 경품,1,0,0,1
이마트패밀리공동기획 행사,마케팅 및 이벤트,0,0,1,1
시네빔 낮에 보기 어려움,제품 비교 및 평가,0,1,0,1
이민자들의 생활,기타,0,0,1,1
이벤트 당첨,마케팅 및 이벤트,0,0,1,1
이마트 트레이더스에서 스탠바이미 판매,기타,0,0,1,1
이벤트 당첨 기대,이벤트 및 프로모션,1,0,0,1
이사 준비,이동 및 설치 용이성,0,0,1,1
이른 도착,기타,0,0,1,1
이동형 제품,제품 디자인 및 이동성,0,0,1,1
시청용으로 좋음,사용 및 설치,1,0,0,1
이벤트 만족,이벤트 및 프로모션,1,0,0,1
이벤트 시작,이벤트 및 혜택,0,0,1,1
이벤트 신청 권장,마케팅 및 판매,0,0,1,1
시나리오 작가,기타,0,0,1,1
이벤트 안내,이벤트 및 혜택,0,0,1,1
영어 실력 향상,기타,1,0,0,1
이색 데이트 코스,기타,1,0,0,1
스피커로 사용,사용 사례 및 추천,0,0,1,1
에어팟맥스,기타,0,0,1,1
스피커 사용,기타,0,0,1,1
스피커 문제,제품 기능 및 사양,0,1,0,1
스피커 만족,제품 기능 및 성능,1,0,0,1
스피커 디자인,제품 기능 및 디자인,0,0,1,1
이천 숙소 추천,기타,0,0,1,1
스피커 내장,기능 및 성능,1,0,0,1
이해와 신뢰 과정 인상적,문화 및 엔터테인먼트,1,0,0,1
스피커 고정 용이,제품 기능 및 사용성,1,0,0,1
인공지능,기능 및 성능,0,0,1,1
인공지능 ThinQ,제품 기능 및 연결성,0,0,1,1
인공지능 리모컨,제품 기능 및 디자인,0,0,1,1
스피커 XT7S 20W,제품 기능 및 디자인,0,0,1,1
인공지능 사운드,플랫폼 및 기술 지원,0,0,1,1
인공지능 화질,제품 기능 및 연결성,0,0,1,1
스플래툰,기타,0,0,1,1
스포티비 이벤트 당첨,이벤트 및 프로모션,1,0,0,1
스포츠채널 라이브 어플 부족,기타,0,1,0,1
야외활동에서 사용,사용 용도 및 환경,1,0,0,1
인공지능씽큐,제품 기능 및 디자인,0,0,1,1
야채주스 정기배송,정기구독 및 서비스,0,0,1,1
인기 많은 제품,고객 만족 및 리뷰,0,0,1,1
스펙 정보 확인,기능 및 사용,0,0,1,1
스펙 정보 제공,제품 정보 및 혜택,0,0,1,1
야쿠르트 팝핑프로바이오틱스,기타,0,0,1,1
스펙 비교,기타,0,0,1,1
에쓰오일 세븐컵 스크린 대회,참여 및 체험,0,0,1,1
에뮬용 사용 가능성,기타,0,0,1,1
스티커 잘 제거됨,개인 사정 및 기타,1,0,0,1
약과도넛,기타,0,0,1,1
스피커 성능 놀람,기능 및 성능,1,0,0,1
스피커 성능 만족,제품 사용 경험 및 평가,1,0,0,1
스피커 성능 좋음,음향 및 스피커,1,0,0,1
스피커 적용,스피커 및 음질,1,0,0,1
이사 후 가전제품 구매,기타,0,0,1,1
스피커 할인,기타,0,0,1,1
이상적인 솔루션,기타,1,0,0,1
스피커 품절,제품 구매 및 기대,0,1,0,1
에어팟 프로2 제공,제품 기대 및 스펙,0,0,1,1
스피커 탑재,구성 및 설치,0,0,1,1
이동형 모니터와 TV 사이의 고민,사용 및 설치 환경,0,0,1,1
스피커 출력 20W,플랫폼 및 기술 지원,0,0,1,1
스피커 출력,기능 및 성능,0,0,1,1
이색체험 공간 확대,기타,0,0,1,1
이야기 마무리,기타,0,0,1,1
이어폰 없음,기타,0,1,0,1
스피커 추가 구매 고려,기타,0,0,1,1
이용 규칙 안내,기타,0,0,1,1
이젤형 스탠드 구매 옵션,스탠바이미 제품,0,0,1,1
에어팟 프로 2세대,기타,0,0,1,1
스피커 장비 세팅 어려움,기타,0,1,0,1
스피커 위치 어색함,기타,0,1,0,1
이용규칙 확인,기타,0,0,1,1
이유식 소분 시 활용,기타,1,0,0,1
이전 모델보다 개선,제품 비교 및 평가,1,0,0,1
에어팟 연결 문제,기타,0,1,0,1
에어텐트 설치 편리,기타,1,0,0,1
야외활동 시 유용,사용 환경 및 용도,1,0,0,1
스피커 옵션 필요 여부,제품 사용 경험 및 평가,0,0,1,1
이전의 명성,기타,0,0,1,1
스피커 역할,기타,1,0,0,1
스피커 아쉬움,기타,0,1,0,1
이동형 사용 편리,이동 및 휴대성,1,0,0,1
식사 중 시청 장소 고민,사용 환경 및 조건,0,0,1,1
이동형 모니터 스탠드,제품 디자인 및 기능,0,0,1,1
야외용 프라이빗 스크린,사용 환경 및 용도,0,0,1,1
신선한 원재료 사용,기타,1,0,0,1
이동 편의성,이동성과 휴대성,0,0,1,1
신상품,제품 상태 및 제조 정보,0,0,1,1
이동 편의성 강화,이동식 TV 및 포터블 스크린,1,0,0,1
이동 활용성,사용 환경 및 설치,1,0,0,1
야외 활동 활용,활용 및 용도,0,0,1,1
야외 활동에서 필요성,기타,1,0,0,1
신상 제품,제품 혁신 및 신제품,0,0,1,1
신상 아이템 소개,신제품 및 출시 소식,0,0,1,1
이동가방 없음,부가 정보 및 기타,0,0,1,1
야외 활용 가능,캠핑 및 야외 활용,1,0,0,1
신변 위험,기타,0,1,0,1
야외에서 대화면 시청,활용 및 용도,1,0,0,1
신박한 디자인,기타,0,0,1,1
엘지 씽큐 통제,제품 기능 및 성능,1,0,0,1
야외에서 이동성 좋음,이동성과 설치,1,0,0,1
신바이오틱스 변경,기타,0,0,1,1
이동성 강화,기타,1,0,0,1
이동성 극대화,사용자 편의성 및 이동성,0,0,1,1
엘지 스탠바이미와 삼성 삼텐바이미 비교,기타,0,0,1,1
이동성 최고,이동성과 휴대성,1,0,0,1
신뢰감,기타,1,0,0,1
신랑의 배려,디자인 및 개인화,1,0,0,1
야외용 캔틸레버 우산,기타,0,0,1,1
신동품 판매,기타,0,0,1,1
엘지 스탠바이미2,스탠바이미 및 스마트 모니터 관련,0,0,1,1
엘지 스탠바이미 추천,사용 경험 및 인기,1,0,0,1
엘지 스탠바이미 정보 제공,스탠바이미 제품 관련,0,0,1,1
신기한 물건에 호기심,기타,0,0,1,1
신세계 상품권 경품,이벤트 및 혜택,0,0,1,1
신세계쓱 가격,기타,0,0,1,1
신속한 처리,서비스 및 지원,1,0,0,1
이동 시 안정적,디자인 및 스타일,1,0,0,1
이동 가능한 스탠드식 무선 스마트 TV,이동식 스마트 TV,0,0,1,1
이동 가능한 스탠바이미 고려,기타,0,0,1,1
이동 및 설치 간편,제품 설치 및 조립,0,0,1,1
엘지 트윈스 챔피언 로고,마케팅 및 이벤트,0,0,1,1
신청곡 가능,기타,1,0,0,1
야외 콘텐츠 즐기기,캠핑 및 야외 활동,1,0,0,1
신청 마감,기타,0,0,1,1
신중한 TV 구매,가격 및 구매,0,0,1,1
엘지 제품 사용,기타,0,0,1,1
이동 쉬운 티비,제품 적합성 및 사용 장소,1,0,0,1
신제품 정보 부족,제품 특징 및 활용,0,1,0,1
이동 스탠드,제품 이동성 및 설치,0,0,1,1
이동 스탠드 조립,편의 및 이동성,0,0,1,1
야외 활동,기타,1,0,0,1
신용카드 할부 가능,거래 및 구매 방법,0,0,1,1
이동 어려움,이동 및 설치,0,1,0,1
신제품 전시,참여 및 체험,0,0,1,1
신제품 불안,기타,0,1,0,1
이동 중 엔터테인먼트,이동 및 휴대성,1,0,0,1
신제품 만족,시장 반응 및 인기,1,0,0,1
이동 중 편리,휴대성과 이동성,1,0,0,1
신제품 기대,마케팅 및 이벤트,0,0,1,1
신제품 고양이간식,기타,0,0,1,1
이동 중 편리한 휴대,제품 휴대성과 이동성,1,0,0,1
야외 활동 최적화,캠핑 및 야외 활동,1,0,0,1
신일선풍기 증정,제품 판매 및 혜택,0,0,1,1
신원CC 에벤에셀 코스 정복,기타,0,0,1,1
이동 중 활용,캠핑 및 이동성,1,0,0,1
신규가입 혜택,소비자 혜택 및 이벤트,0,0,1,1
이동식 TV 구매 고민,제품 특징 및 사용성,0,0,1,1
엘지 디스플레이 감성,브랜드 및 광고,1,0,0,1
이동이 간편한 디자인,제품 특성 및 기능,1,0,0,1
엑스붐 360 모델 추천,제품 특징 및 활용,0,0,1,1
이동식 스탠드 활용,이동성과 설치,1,0,0,1
이동식 스탠바이미 사용,사용자 편의성 및 이동성,1,0,0,1
이동식 스탠바이미 쓸모,제품 특징 및 사용성,0,0,1,1
식상한 구조 대체,기타,1,0,0,1
에코플로우 파워뱅크 연결,이동식 TV 및 포터블 스크린,0,0,1,1
이동식 텔레비전,제품 기능 및 성능,0,0,1,1
식사와 함께 시청,가족 및 공동 사용,0,0,1,1
에코백과 헬리녹스 패치 제공,제품 교환 및 거래,0,0,1,1
이동식 티비 사용,기타,0,0,1,1
이동식 티비거치대,캠핑 및 휴대성,0,0,1,1
이동식 티비스탠드,이동성과 휴대성,0,0,1,1
이동식 휠로 쉬운 이동,사용 경험,1,0,0,1
이동이 많은 수업에 적합,사용 환경 및 편리성,1,0,0,1
식탁 고정 사용,기타,0,0,1,1
이동형,이동 및 휴대성,1,0,0,1
에어플레이2 지원,제품 기능 및 연결성,0,0,1,1
에어플레이 해상도 불일치,기능 및 성능,0,1,0,1
이동형 TV 구매 추천,제품 특성 및 용도,1,0,0,1
식사시간 TV 시청,제품 특징 및 활용,1,0,0,1
이동형 TV 렌탈,제품 디자인 및 이동성,0,0,1,1
스티븐 킹의 자전적 이야기,기타,0,0,1,1
이동형 TV 연상,기타,0,0,1,1
이동형 TV 필요,설치 및 이동성,0,0,1,1
이동형 TV로 각광,휴대성과 보관,1,0,0,1
에어플레이 지원 기대,제품 특성 및 기능,1,0,0,1
식사 중 TV 시청,사용 환경 및 편리성,1,0,0,1
이동형 기기,이동성과 휴대성,0,0,1,1
식전영상 활용,교육 및 특별 용도,0,0,1,1
이동식 스탠드 패키지,디자인 및 공간 활용,0,0,1,1
신규 출시,제품 출시 및 인지도,0,0,1,1
엔터테인먼트 조화,기타,0,0,1,1
신규 입고,신제품 및 출시 소식,0,0,1,1
이동식 TV 스탠드,제품 디자인 및 기능,0,0,1,1
이동식 TV의 선두주자,기타,1,0,0,1
이동식 TV의 장점,이동식 TV 및 포터블 스크린,1,0,0,1
이동식 TV형 모니터 사용,제품 특징 및 비교,0,0,1,1
엘지 공식사이트 구매 불가,결제 및 구매 관련,0,0,1,1
신규 모델 발탁,기타,0,0,1,1
이동식 가능,이동 및 휴대성,1,0,0,1
신규 모델,제품 상태 및 가격,0,0,1,1
이동식 거치대 구매,이동 및 설치 용이성,0,0,1,1
신규 가입 및 응모 혜택,부가 서비스 및 혜택,1,0,0,1
엔텐바이미 설치,이동 및 설치,0,0,1,1
이동식 라이프 스타일 스크린,이동성과 휴대성,0,0,1,1
이동식 모델 야외 사용 편리,사용자 경험,1,0,0,1
이동식 스탠드 장점,이동식 스마트 TV,1,0,0,1
이동식 무게잡이,사용 및 설치 환경,0,0,1,1
이동식 무선 스마트 TV,제품 기능 및 디자인,0,0,1,1
신개념 TV,기타,0,0,1,1
식탁에서 시청,사용 환경 및 용도,0,0,1,1
이동식 스크린,휴대성과 이동성,0,0,1,1
이동식 스크린 선호,기타 기능 및 고민,0,0,1,1
엔터테인먼트 업그레이드,제품 평가 및 후기,1,0,0,1
이동식 스탠드 TV,이동성과 휴대성,0,0,1,1
식탁 앞에서 사용,사용 환경 및 목적,0,0,1,1
식탁 구매,기타,0,0,1,1
엔터테인먼트,기타,0,0,1,1
이동식 스탠드 스마트TV,제품 성능 및 기능,0,0,1,1
이동식 스탠드 스크린 인기,캠핑 및 외부 활용,1,0,0,1
스티커 수집,기타,0,0,1,1
인기 예상,제품 평가 및 기대,0,0,1,1
약물중독 사건,기타,0,1,0,1
입주 전 사치로 구매 안 함,부정적 평가,0,0,1,1
자가 설치 가능,사용자 경험,0,0,1,1
자가격리로 인한 배송 불편,제품 출시 및 리뷰,0,1,0,1
스탠바이미고 제품 관심,제품 출시 및 관심,1,0,0,1
언박싱 기대감,기타,1,0,0,1
언박싱 경험,기타,1,0,0,1
어두운 영역 디테일 표현,화질 및 화면,1,0,0,1
어디든 함께 하고 싶음,기타,0,0,1,1
자기전 넷플릭스 시청,제품 특징 및 활용,1,0,0,1
자기전 시청,사용 경험 및 후기,1,0,0,1
어플 초기설정 설명 부족,제품 사용 및 설치,0,1,0,1
어디든 휴대 가능,캠핑 및 휴대성,1,0,0,1
스탠바이미고 제작 어려움,기타,0,0,1,1
자녀 화면 터치 문제,문제 및 개선점,0,1,0,1
스탠바이미고 정보 제공,기타,0,0,1,1
자동 모바일 연결,기술 및 기능,1,0,0,1
스탠바이미고 접이식 디자인,제품 디자인 및 구조,0,0,1,1
스탠바이미고 장단점,제품 인기 및 추천,0,0,1,1
스탠바이미고 이벤트 발견,이벤트 및 혜택,0,0,1,1
"스탠바이미고 월 32,500원",기타,0,0,1,1
자동 스타일,제품 기능 및 사용성,1,0,0,1
자동 인식,제품 기능 및 성능,1,0,0,1
스탠바이미고 우수한 기능,제품 성능,1,0,0,1
자동 청소 및 건조,기타 제품 및 서비스,1,0,0,1
자동 켜짐,제품 기능 및 사용성,1,0,0,1
자동 켜짐 기능,다양한 기능 및 설정,0,0,1,1
자동연결 기능,제품 특징 및 사용성,1,0,0,1
자동차 사용,기타,0,0,1,1
자랑스러움,제품 만족도 및 홍보,1,0,0,1
자리 차지,사용 편의성 및 기능,0,1,0,1
있으면 좋음,기타 기능 및 고민,1,0,0,1
입주,마케팅 및 판매,0,0,1,1
자리 차지 적음,제품 기능 및 사양,1,0,0,1
스탠바이미고 제품 보유,기타,0,0,1,1
일정 변동 가능,이벤트 및 프로모션,0,0,1,1
일체형 구조,제품 활용 및 기능,0,0,1,1
엄청난 상품,사용자 경험 및 리뷰,1,0,0,1
스탠바이미고 판매 고려,기타,0,0,1,1
얼리 어답터,기타,0,0,1,1
얼굴 공개 어려운 인물 인터뷰 가능,기타,0,0,1,1
스탠바이미고 캠핑카 여행,이동 및 캠핑 활용,0,0,1,1
스탠바이미고 출시,제품 출시 및 이벤트,0,0,1,1
스탠바이미고 체험단,제품 출시 및 트렌드,0,0,1,1
스탠바이미고 챔피언에디션 미개봉,한정판 및 기념품,0,0,1,1
언제 어디서든 사용 가능,기타,1,0,0,1
스탠바이미고 챔피언 에디션 미개봉,제품 특징 및 기능,0,0,1,1
일체형 세탁건조기 워시타워,기타,0,0,1,1
일체형 스탠드 디자인,기타,1,0,0,1
일체형 아님,기타,0,1,0,1
얇은 베젤,기타,1,0,0,1
일체형 여부,제품 기능 및 사양,0,0,1,1
언박싱 후기,기타,0,0,1,1
일체형 캐리백 디자인,기타,0,0,1,1
임산부 사용,건강 및 생활,1,0,0,1
임소영 DJ,기타,0,0,1,1
언박싱 도움,기타,0,0,1,1
임직원 세일,제품 상태 및 가격,0,0,1,1
입식 테이블 선호,사용 및 설치 환경,0,0,1,1
입자가 작은 두부모래,기타,1,0,0,1
스탠바이미고 증정,특별한 경험 및 기능,0,0,1,1
스탠바이미고 즐김,제품 인기 및 추천,1,0,0,1
입장 절차,기타,0,0,1,1
스탠바이미고 제품 정보,기타,0,0,1,1
스탠바이미고 올려놓기 좋음,기타,1,0,0,1
자막 선택 기능,사용자 편의 및 기능,1,0,0,1
스티븐 킹의 공포소설,문화 및 엔터테인먼트,0,0,1,1
스탠바이미고 세일,제품 특징 및 기능,0,0,1,1
작가 설명란 인상적,문화 및 엔터테인먼트,1,0,0,1
작가 직업에 대한 부정적 인식,문화 및 엔터테인먼트,0,1,0,1
작가가 될 가능성,문화 및 엔터테인먼트,1,0,0,1
작년 모델과 올해 모델 비교,제품 및 모델 비교,0,0,1,1
작동 상태 확인,제품 상태 및 신뢰성,0,0,1,1
작동 이상 없음,기타,1,0,0,1
작동법 설명,기타,0,0,1,1
작동법 익히기,기타,0,0,1,1
작아진 사이즈,제품 크기 및 디자인,1,0,0,1
작아진 화면에 대한 우려,제품 특징 및 활용,0,1,0,1
작은 거실에 적합,사용 환경 및 용도,0,0,1,1
어렵게 구매한 스탠바이미,제품 출시 및 리뷰,0,0,1,1
어른이 되면서 다시 보고 싶은 애니메이션,문화 및 엔터테인먼트,0,0,1,1
작은 공간 활용,사용 편의성 및 기능,0,0,1,1
스탠바이미고 선물,제품 인기 및 추천,1,0,0,1
어린시절 향수 자극,기타,1,0,0,1
어린 아이로 인해 86인치 TV 사용 제한,기타,0,0,1,1
스탠바이미고 상품,기타,0,0,1,1
작은 공간에 적합,사용 용도 및 환경,1,0,0,1
스탠바이미고 사은품 제공,캠핑 및 야외 활동,1,0,0,1
작은 돔텐트 원함,부가 정보 및 기타,0,0,1,1
스탠바이미고 사용 횟수,제품 교환 및 거래,0,0,1,1
작은 마을 캐슬록,영화 및 문학 관련,0,0,1,1
작은 부피,기타,1,0,0,1
작은 사진도 잘 보임,사용자 경험 및 만족도,1,0,0,1
작은 원룸에서도 사용 가능,사용 용도 및 환경,1,0,0,1
작은 집에 적합,제품 설치 및 사용 환경,0,0,1,1
스탠바이미고 보관 박스,부가 정보 및 기타,0,0,1,1
작은 평수 신혼가구,구매 고려 및 비교,0,0,1,1
자취생 필수품,가격 및 구매,1,0,0,1
자취방 추천,제품 특성 및 기능,1,0,0,1
어릴 때의 기억,영화 및 문학 관련,0,0,1,1
자취방 및 인테리어용 TV,사용 환경 및 용도,0,0,1,1
자막 선택 기능 만족,기능 및 성능,1,0,0,1
어디서나 사용 가능,다양한 사용 환경,1,0,0,1
자석 부착,기술 및 기능,0,0,1,1
자석 스탠드,기타,0,0,1,1
자세한 내용 및 혜택 전달,기타,0,0,1,1
자세한 정보 및 구입 방법 제공,서비스 및 지원,0,0,1,1
어디서나 영화관,사용 장소 및 활용,1,0,0,1
어디에 놓아도 예쁨,디자인 및 외관,1,0,0,1
자신에 대한 단정,기타,0,0,1,1
자연과 함께 사용,사용 환경 및 활용,1,0,0,1
어딘가 올려놓아야 함,캠핑 및 외부 활용,0,1,0,1
스탠바이미고 예약,기타,0,0,1,1
자유로운 감상,기타,0,0,1,1
자유로운 공간 이동,캠핑 및 휴대성,0,0,1,1
자유로운 영상 및 정보 접근,기능 및 성능,1,0,0,1
스탠바이미고 영입,제품 특징 및 기능,1,0,0,1
스탠바이미고 영상노출기기 검색,제품 특징 및 기능,0,0,1,1
자유로운 영상 시청,사용자 경험,1,0,0,1
스탠바이미고 언급,제품 모델 및 출시,0,0,1,1
어린아이 있는 집 사용 후기 요청,사용 환경 및 용도,0,0,1,1
스탠바이미고 실물 만족,제품 및 모델 비교,1,0,0,1
스탠바이미고 수령,특별한 경험 및 기능,1,0,0,1
어린아이 있는 집 사용,사용자 경험 및 평가,0,0,1,1
자유로운 이동성,이동 및 휴대성,1,0,0,1
어려운 캐스팅 작업,기타,0,0,1,1
자주 사용하지 않음,사용자 경험 및 리뷰,0,1,0,1
자주 영화 시청,기타,1,0,0,1
자체 설치 불가,기타,0,1,0,1
자취방 꾸미기,디자인 및 외관,0,0,1,1
업그레이드,시장 및 경제,1,0,0,1
스탠바이미고 팝업스토어,개인 사정 및 기타,0,0,1,1
스탠바이미고 패키지,추가 기능 및 혜택,1,0,0,1
인덕션/냉장고/전자레인지/정수기 제공,제품 기능 및 성능,1,0,0,1
인버터 가동전력,기술 및 기능,0,0,1,1
업데이트 가능성,기타,0,0,1,1
업그레이드된 화질,기타,1,0,0,1
인스타그램 업로드,기타,0,0,1,1
스탠바이미와 유사한 제품,제품 비교 및 차별성,0,0,1,1
스탠바이미와 스피커 세트 구입,제품 비교,0,0,1,1
스탠바이미와 스탠바이미고 조합,기타,1,0,0,1
스탠바이미와 스탠바이미고 비교 고민,제품 비교 및 평가,0,0,1,1
업그레이드된 제품,기타,1,0,0,1
인스타그램 인증,기타,0,0,1,1
인스타에 알려지지 않은 LP바 느낌,기타,1,0,0,1
스탠바이미와 스타일러 비교,제품 비교 및 선택,0,0,1,1
스탠바이미와 쇼파 공간,디자인 및 스타일,0,0,1,1
업그레이드된 신제품,제품 기능 및 성능,0,0,1,1
인증사진 추첨 이벤트,프로모션 및 이벤트,0,0,1,1
인지도 높은 제품,제품 출시 및 인지도,0,0,1,1
업그레이드된 스펙,기타,1,0,0,1
인천 직거래 가능,지역 및 거래 조건,0,0,1,1
스탠바이미와 삼탠바이미 비교,스탠바이미 관련,0,0,1,1
인체 척추라인 유지,건강 및 안전,1,0,0,1
스탠바이미와 삼탠바이미 고민,사용자 경험,0,0,1,1
스탠바이미와 빔프로젝터 사용 고민,구매 고려 및 비교,0,0,1,1
인치 만족,기능 및 사용,1,0,0,1
인크레더블탱크 게임 20번 레벨 어려움,기타 제품 및 서비스,0,1,0,1
인터넷 IPTV 결합 상품,기술 및 기능,0,0,1,1
스탠바이미와 빔 프로젝트 비교,제품 특징 및 활용,0,0,1,1
인터넷 가입 시 사은품 추천,가격 및 구매,0,0,1,1
인터넷 교체로 할인 구매 가능,가격 및 거래 조건,0,0,1,1
스탠바이미와 비교,브랜드 및 모델,0,0,1,1
스탠바이미와 일반 TV 비교,제품 특징 및 비교,0,0,1,1
스탠바이미와 팬히터 구매 가능성,제품 특징 및 활용,0,0,1,1
스탠바이미고 패키지 미존재,기타,0,1,0,1
인기몰이,시장 및 소비자 반응,1,0,0,1
스티븐 킹 원작 영화,영화 및 문화,0,0,1,1
스티븐 킹 소설 원작,영화 및 문화,0,0,1,1
스티븐 킹 소설 기반,영화 및 문학 관련,0,0,1,1
스트리밍 서비스 구독 고민,기타,0,0,1,1
인기 소설가,기타,0,0,1,1
신품 미개봉,제품 상태 및 사용,0,0,1,1
스트리밍 가능,제품 및 기능,0,0,1,1
인기 의문,제품 불만 및 실망,0,0,1,1
인기 있는 LG 가전,기타,0,0,1,1
스텐바이미 고,기타,0,0,1,1
인기 있는 LP바,기타,1,0,0,1
에너지 효율성,에너지 및 환경,1,0,0,1
인기 있는 보호필름,기타,1,0,0,1
인기 있는 스탠드,기타,0,0,1,1
인기 있는 스탠바이미 필름,기타,1,0,0,1
인기 있는 액정 보호 필름,기타,1,0,0,1
스탠에서 하프스터디 가능,제품 및 모델 비교,0,0,1,1
인기 있는 이동식 TV,기타,0,0,1,1
인기 있는 전자제품,긍정적 평가,1,0,0,1
스탠바이비 경품,참여 및 이벤트,0,0,1,1
업무용 모니터로 사용,기타,1,0,0,1
스탠바이미티비 정보 제공,기타,0,0,1,1
인기 있는 핫플레이스,기타,1,0,0,1
스탠바이미처럼 사용,사용 사례 및 추천,0,0,1,1
스탠바이미의 지속적인 인기,제품 만족도 및 인기,1,0,0,1
인기 있는 휴대용 디스플레이,기타,1,0,0,1
스탠바이미의 매력,스탠바이미 제품 관련,1,0,0,1
인기 증가,사용 경험 및 인기,1,0,0,1
스탠바이미의 등장,스탠바이미 제품 및 기능,0,0,1,1
인터넷 브라우저 동시 사용 가능,기술 및 기능,1,0,0,1
스탠바이미와 벽걸이/스탠드 TV 비교,구매 고려 및 비교,0,0,1,1
인터넷 영상,다양한 기능 및 설정,0,0,1,1
인터넷 웨이브 홈 시청,문제 및 불만,0,0,1,1
일괄 구매 시 네고,제품 구매 및 거래,0,0,1,1
업그레이드된 사운드,음향 및 스피커,1,0,0,1
일반 TV 시청 불가,기타,0,1,0,1
스탠바이미고와 유사한 디자인,제품 비교 및 기타,0,0,1,1
일반 TV보다 저렴,거래 및 가격,0,0,1,1
스탠바이미고와 교환 원함,제품 교환 및 거래,0,0,1,1
일반 TV와 비교,제품 비교 및 선택,0,0,1,1
약한 액정,기타,0,1,0,1
스탠바이미고와 게임기 연결,추가 기능 및 혜택,0,0,1,1
얇은 가방,디자인 및 소재,0,1,0,1
일반 스탠바이미 교환 가능,추천 및 계획,0,0,1,1
스탠바이미고로 노래 재생,기타,1,0,0,1
업그레이드된 모델,기타,0,0,1,1
스탠바이미고2 구매,제품 특성 및 용도,0,0,1,1
일본 아카데미상 애니메이션 우수상 수상,문화 및 이벤트,1,0,0,1
일본여행 구매,기타,0,0,1,1
일상 관리 편리,사용 편의성,1,0,0,1
일상 속 편리함,사용 및 활용,1,0,0,1
스탠바이미고 흠집 방지,개인 사정 및 기타,0,0,1,1
일상생활 편의성,사용 만족 및 편의성,1,0,0,1
스탠바이미고 획득 가능,제품 출시 및 관심,1,0,0,1
스탠바이미고 화제,신제품 및 출시 소식,0,0,1,1
스탠바이미고 호환,제품 및 액세서리,0,0,1,1
일상에서 사용,사용 환경 및 장소,0,0,1,1
일시불 구매 부담,구매 및 판매 정보,0,1,0,1
업그레이드 버전,기타,0,0,1,1
스탠바이미고 할인,마케팅 및 판매,0,0,1,1
스탠바이미고 한정판 판매,스탠바이미 제품 관련,0,0,1,1
일시적인 존재감,기타,0,0,1,1
스탠바이미고의 장점,기타,1,0,0,1
인테리어와 조화로운 히든 바퀴,제품 설치 및 사용 환경,1,0,0,1
스탠바이미는 TV,기타,0,0,1,1
스탠바이미와 TV 비교,스탠바이미 제품 및 기능,0,0,1,1
업그레이드된 스탠바이미,스탠바이미 제품,0,0,1,1
인터넷 활용,제품 특성 및 기능,1,0,0,1
인터넷보다 저렴,가격 및 비용,1,0,0,1
인터넷에서 인기,사용자 경험 및 리뷰,0,0,1,1
인테리어,디자인 및 인테리어,0,0,1,1
인테리어 가능,기타,1,0,0,1
스탠바이미와 기존 TV 설치 고민,제품 비교 및 선택,0,0,1,1
스탠바이미와 광파오븐 필요,제품 특성 및 용도,0,0,1,1
스탠바이미와 광파오븐 우선 선택,구매 및 선택 고민,0,0,1,1
인테리어 소품,기타,1,0,0,1
인테리어 소품으로 사용,디자인 및 인테리어,0,0,1,1
인테리어 스피커로 사용,기타,0,0,1,1
인테리어 영향 없음,인테리어 및 디자인,1,0,0,1
인테리어 용도,사용 사례 및 추천,0,0,1,1
스탠바이미로 결정,스탠바이미 제품 관련,0,0,1,1
인테리어 적합,기타,1,0,0,1
스탠바이미에 대한 긍정적 감정,기타,1,0,0,1
약한 다리,부정적 평가,0,1,0,1
인테리어 측면,디자인 및 외관,1,0,0,1
스탠바이미에 대한 관심,시장 반응 및 인기,0,0,1,1
스탠바이미로 큰 화면 시청 희망,제품 사용 및 기능,0,0,1,1
스탠바이미로 충분히 즐길 수 있음,스탠바이미 및 스마트 모니터 관련,1,0,0,1
스탠바이미로 충분,구매 고려 및 비교,0,0,1,1
스탠바이미로 음악 즐기기,사용자 경험,1,0,0,1
업그레이드된 성능,제품 기능 및 성능,1,0,0,1
인테리어 테마,디자인 및 인테리어,0,0,1,1
스탠바이미로 운동 가능,사용 용도 및 기능,1,0,0,1
인테리어와 어울림,고객 경험 및 만족도,1,0,0,1
엘지 틔운,기타,0,0,1,1
이동 가능성,이동식 스마트 TV,0,0,1,1
이동 가능한 스크린 TV,이동성과 휴대성,1,0,0,1
아이에너지T12 보조배터리 소개,기타,0,0,1,1
오토캠핑,사용 용도 및 환경,0,0,1,1
오토캠핑 못 감,사용 환경 및 용도,0,1,0,1
오토피벗 미지원,제품 기능 및 사용,0,1,0,1
아이패드로 주로 시청,기타,0,0,1,1
아이패드 부착 가능,기타,1,0,0,1
아이의 출생은 부모의 선택,기타,0,0,1,1
오프라인 구매 가능,가격 및 구매,0,0,1,1
오프라인 매장 가격,가격 및 구매 옵션,0,0,1,1
아이의 TV 소원,사용 환경 및 조건,0,0,1,1
액정보호,기타,0,0,1,1
아이와 함께 사용 가능,사용자 경험,1,0,0,1
오프라인 판매 시작,제품 출시 및 홍보,0,0,1,1
오프라인 행사,이벤트 및 프로모션,0,0,1,1
오픈마켓에서 더 저렴,구매 및 가격 혜택,0,0,1,1
아이에너지T12 보조배터리,기타,0,0,1,1
우수한 디자인,디자인 및 크기,1,0,0,1
액정보호필름,기타,1,0,0,1
오픈행사 안내,프로모션 및 이벤트,0,0,1,1
오피스 환경 개선,기타,0,0,1,1
오피스텔 무료 인터넷 채널 많음,제품 적합성 및 사용 장소,0,0,1,1
아이스 아메리카노 경품,이벤트 및 혜택,0,0,1,1
아이보리 화이트 컬러,제품 기능 및 디자인,1,0,0,1
온누리상품권 결제 가능,가격 및 결제 옵션,0,0,1,1
온누리상품권 할인,가격 및 할인,1,0,0,1
아이보리 색상 만족,제품 디자인 및 기능,1,0,0,1
온라인 가격,가격 및 구매 옵션,0,0,1,1
온라인 강의 시청,활용 및 적합성,0,0,1,1
아이들이 있는 가정에서 인기,사용 환경 및 용도,1,0,0,1
올레TV 시청 가능 여부,사용 환경 및 용도,0,0,1,1
역류방지,건강 및 생활,1,0,0,1
오염물질 방지,보호 및 내구성,0,0,1,1
오염 있음,사용자 경험,0,0,1,1
오션뷰,기타,0,0,1,1
액정 불량,기타,0,1,0,1
아크릴 리모컨 보관함 증정,기타,0,0,1,1
오래 사용 기대,기타,1,0,0,1
오래된 TV 교체 희망,TV 구매 및 사용 고민,0,0,1,1
오래된 모델,제품 구매 및 기대,0,0,1,1
오래된 벽걸이 티비,제품 비교 및 평가,0,0,1,1
아침 소음 필요,기타,0,0,1,1
오래된 티비 대체,구매 및 선택 고민,0,0,1,1
연결 가이드,편의성과 활용,1,0,0,1
아이폰과의 연결 문제,제품 특징 및 사용,0,1,0,1
역삼푸르지오 가격 변동,기타,0,0,1,1
아이폰 연결 불편,제품 특징 및 사용성,0,1,0,1
역삼푸르지오,기타,0,0,1,1
아이폰 및 스탠바이미 연결 어려움,제품 특징 및 활용,0,1,0,1
오래된 회사,브랜드 및 시장 반응,0,0,1,1
역류성식도염베개로 사용,기타,0,0,1,1
아이폰 미러링 문제,기능 및 기술,0,1,0,1
아이폰 미러링 가능,기타,0,0,1,1
역류성식도염 환자 많음,기타,0,0,1,1
역류성식도염 완화,기타,0,0,1,1
액정 보호필름 소개,부가 기능 및 기타,0,0,1,1
아이폰 미러링,기능 및 성능,0,0,1,1
오랜 대기 후 구매,구매 및 경제성,0,0,1,1
아이폰 모니터링,제품 기능 및 사용성,1,0,0,1
오랜만에 본 제품,브랜드 및 시장 반응,0,0,1,1
아이폰 기종 지원 필요,제품 특징 및 활용,0,1,0,1
역류성 식도염 완화,기타,1,0,0,1
오리지널 제품 추천,제품 비교 및 추천,1,0,0,1
아이폰 15,기타,0,0,1,1
오브제 컬렉션과 유사한 디자인,제품 디자인 및 트렌드,1,0,0,1
올레포빅 기능,기술 및 성능,0,0,1,1
아이들에게 지루하지 않은 시간 제공,기타,1,0,0,1
올릴 곳 부족,기타 이슈 및 요구,0,1,0,1
완전 새제품,제품 상태 및 구성,1,0,0,1
여행에서 사용 희망,기타,0,0,1,1
완판 인기,기타,0,0,1,1
아이돌 감상,기타,0,0,1,1
아이 학습 및 놀이,활용 및 적합성,0,0,1,1
왕초보 영어 공부에 적합,부가 정보 및 기타,1,0,0,1
외국어 공부에 적합,교육 및 학습,1,0,0,1
외국인 간병사와의 의사소통,기타,0,0,1,1
아이 학대 문제,기타,0,1,0,1
외부 사용 가능,사용 용도 및 적합성,0,0,1,1
외부 스피커 기능 기대,제품 기능 및 사양,0,0,1,1
외부 활용 가능,이동성과 휴대성,0,0,1,1
외부에서도 또렷한 화면,기타,1,0,0,1
외형적 차이 없음,디자인 및 외관,0,0,1,1
요금제 제한으로 앱 실행 불가,기타,0,1,0,1
요리 레시피 활용,특정 사용자 및 활용 사례,1,0,0,1
요리 보조로 사용,기타,0,0,1,1
아이 있는 집에 적합,기타,0,0,1,1
요리 시 레시피 검색,기타,0,0,1,1
요리 시 레시피 확인,기타,0,0,1,1
요리 시 레시피북 활용,기타,1,0,0,1
요리 시 사용,기타,0,0,1,1
요리 중 영상 시청,기타,0,1,0,1
요리 중 유튜브/인터넷 사용,사용 환경 및 활용도,1,0,0,1
요추전만 유지,기타,0,0,1,1
아이 있는 집 사용 고민,사용 환경 및 조건,0,0,1,1
아이 있는 가정에서 사용 우려,제품 적합성 및 사용 장소,0,0,1,1
우르비노 5pcs 세트,기타,0,0,1,1
우석이의 귀여운 행동,기타,1,0,0,1
아이 있는 가정,사용 환경 및 용도,0,0,1,1
완전 판매,기타,1,0,0,1
아이두젠 스탠비백 우수한 디자인,브랜드 및 모델,1,0,0,1
올인원 로봇청소기,기타 제품 및 서비스,1,0,0,1
완성도 높은 디자인,디자인 및 공간 활용,0,0,1,1
옷에 관심 없음,기타,0,0,1,1
와이파이 환경 연동,운영 및 환경,0,0,1,1
와이프 만족,사용자 경험 및 만족도,1,0,0,1
와이프 몰래 구매,기타,0,0,1,1
와인 마시기 좋은 분위기,기타,1,0,0,1
와인 및 위스키,기타,0,0,1,1
와인바,위치 및 환경,0,0,1,1
아이들과의 공유 시간 증가,기타,1,0,0,1
아이들과 함께 사용,사용 환경 및 장소,1,0,0,1
와인바 경험,장소 및 분위기,0,0,1,1
완벽 호환,기타,0,0,1,1
완벽한 TV 대체 불가,화질 및 성능,0,0,1,1
역대급 명작 평가,기타,0,0,1,1
액정보호필름 문의,기타,0,0,1,1
아이들과 사용,사용자 경험 및 평가,1,0,0,1
완벽한 내구성,내구성 및 안정성,1,0,0,1
아이들 활동,기타,0,0,1,1
아이들 컨텐츠,학습 및 콘텐츠,1,0,0,1
아이들 점령으로 인한 개인용 스탠바이미 구매,사용 환경 및 조건,0,0,1,1
여행용 가방 형태,기타,0,0,1,1
완벽한 디스플레이,라이프스타일 및 경험,1,0,0,1
완벽한 멀티미디어 솔루션,제품 평가 및 후기,1,0,0,1
아이들 재우기 도움,기타,1,0,0,1
완벽한 테이블 색상 및 크기,제품 설치 및 사용 환경,1,0,0,1
아이들 있는 가정에서 인기,기타,1,0,0,1
아이들 바인딩 용도,사용 사례 및 추천,1,0,0,1
아이들 눈 건강 보호,기타,1,0,0,1
아이두젠 스탠비백 우수한 사용방법,브랜드 및 모델,1,0,0,1
완벽함,제품 특성 및 디자인,1,0,0,1
연결 사용 가능성,사용 편의성 및 기능,0,0,1,1
연결버튼 귀찮음,제품 특징 및 사용성,0,1,0,1
오늘의집 큐레이터 활동,브랜드 및 광고,0,0,1,1
애니메이션,문화 및 이벤트,0,0,1,1
영화 감독 및 출연진 정보,영화 및 문화,0,0,1,1
안정적인 손잡이,기타,1,0,0,1
안정적인 보호,기타,1,0,0,1
안정적인 무게감,제품 특성 및 디자인,1,0,0,1
안정적인 거치,기능 및 성능,1,0,0,1
영화 감상 자유로움,기능 및 성능,1,0,0,1
영어 공부 무료,교육 및 학습,0,0,1,1
영화 개봉 지연,영화 및 문화,0,1,0,1
안정성,내구성 및 안정성,0,0,1,1
영화 개봉일,기타,0,0,1,1
영화 굿즈 제공,이벤트 및 프로모션,0,0,1,1
영화 모험 내용,콘텐츠 및 감상,0,0,1,1
애니메이션 예매율 1위,제품 특성 및 기능,1,0,0,1
영화 및 게임 감상 최적,기타,1,0,0,1
안정감 있는 손잡이,이동 및 설치,1,0,0,1
영화 및 드라마 시청,사용자 경험,1,0,0,1
영화 배경,영화 및 문화,0,0,1,1
영화 상영 일정,영화 및 문화,0,0,1,1
애니메이션 인기,영화 및 문화,0,0,1,1
안전한 휴대성,제품 휴대성과 이동성,1,0,0,1
안전한 이동,캠핑 및 휴대성,1,0,0,1
안전한 수납,문제 및 개선점,1,0,0,1
영화 스탠 바이 미 넷플릭스 공개,영화 및 문화,0,0,1,1
영화 스탠 바이 미 정보,영화 및 문화,0,0,1,1
안전한 사용,제품 활용 및 기능,1,0,0,1
영화 스탠드 바이 미,영화 및 문화,0,0,1,1
영화 시청 선호,제품 사용 및 기능,0,0,1,1
안전한 보호,보안 및 안전,1,0,0,1
안전한 보관 및 이동,공간 및 휴대성 문제,1,0,0,1
영화 감독,기타,0,0,1,1
영화 <스탠 바이 미> 소개,영화 및 문화,0,0,1,1
영화 시청 행복,기타,1,0,0,1
영화 '스탠 바이 미' 재개봉,영화 및 문화,0,0,1,1
영어 원서 읽기 가능 여부,기타,0,0,1,1
암부 기존 seetec과 동일,개인 사정 및 기타,0,0,1,1
알피쿨 25사이즈 이마트 제품 고려,기타,0,0,1,1
영어 자막 없음,콘텐츠 및 감상,0,1,0,1
알피쿨 25사이즈 고려,기타,0,0,1,1
영어 학습 시작,학습 및 콘텐츠,1,0,0,1
영어 학습기 선택 고민,기타,0,0,1,1
영어 공부에 도움,교육 및 학습,0,0,1,1
영어공부 가능,교육 및 학습,0,0,1,1
영어공부 열정,교육 및 학습,1,0,0,1
영어공부용,제품 활용 및 기능,0,0,1,1
영어 공부 평생 무료,구매 및 사용 경험,0,0,1,1
알파룸 TV 정리 고려,사용 용도 및 환경,0,0,1,1
알파7 인공지능 프로세서,제품 내구성 및 성능,0,0,1,1
영어학습기 구입,사용자 경험,0,0,1,1
영어 공부 옵션 다양,학습 및 콘텐츠,0,0,1,1
영어학습기 신청 시 혜택,기타 제품 및 서비스,0,0,1,1
알찬 구성,기타,1,0,0,1
알뜰폰 변경,기타,0,0,1,1
암호코드 입력 번거로움,제품 성능 및 기능,0,1,0,1
영어학습기 원조,기타,1,0,0,1
영어회화 프로그램 신청 혜택,기타,1,0,0,1
영업 시간,기타,0,0,1,1
영업시간,기타,0,0,1,1
알 수 없는 의식의 흐름,기타,0,0,1,1
암호화,보안 및 안전,1,0,0,1
안주 준비,장소 및 분위기,0,0,1,1
영화 '구니스'와 '스탠 바이 미' 연달아 시청,영화 및 문화,0,0,1,1
영화 '스탠 바이 미' 감독 및 출연진,영화 및 문화,0,0,1,1
안전한 보관,사용 사례 및 추천,0,0,1,1
영화 시청에 유용,제품 사용 경험 및 평가,1,0,0,1
안드로이드 및 IOS 미러링 가능,기능 및 성능,0,0,1,1
안방에 TV 설치 고민,가전 및 가구 선택 고민,0,0,1,1
애플워치,기타,0,0,1,1
안방에 TV 두는 것에 대한 불호,사용 및 설치 환경,0,1,0,1
영상 시청,제품 사용 경험,0,0,1,1
예쁜 집 꾸미기,제품 크기 및 디자인,0,0,1,1
영상 송출 기능 변경 필요,기타,0,1,0,1
예쁜 캐리백,기타 기능 및 옵션,1,0,0,1
안방 및 주방 사용,사용 환경 및 용도,0,0,1,1
안방 및 식탁에서 시청,사용 환경 및 용도,0,0,1,1
안방 TV 없음,사용 환경 및 조건,0,0,1,1
예상치 못한 구매,구매 및 소비,0,0,1,1
애플워치 경품,마케팅 및 프로모션,0,0,1,1
영상 보기 좋음,기능 및 성능,1,0,0,1
안방 TV 설치 불가능,사용 환경 및 편리성,0,0,1,1
연장코드,기타,0,0,1,1
안방 TV 설치 고민,사용 및 설치 환경,0,0,1,1
액세서리 보관,기술 및 기능,0,0,1,1
안마의자에서 스탠바이미 유튜브 시청,기타,0,0,1,1
예약구매 성공,구매 및 이벤트,0,0,1,1
안드로이드폰 화면 공유 가능,기타,0,0,1,1
액정 기스 걱정,제품 내구성 및 품질,0,1,0,1
연수장치,기타,0,0,1,1
연말행사 초대,기타,0,0,1,1
예정보다 빠른 배송,배송 및 설치,1,0,0,1
연말 분위기 즐김,기타 기능 및 특징,1,0,0,1
예정에 없던 구매,기타,0,0,1,1
오늘의집 방문 의향,고객 경험 및 만족도,0,0,1,1
안드로이드/윈도우 화면 공유,기능 및 호환성,0,0,1,1
안드로이드 폰 호환,기능 및 사용성,0,0,1,1
연구실에서 사용,사용 환경 및 장소,0,0,1,1
예쁜 스탠드형 TV,제품 크기 및 디자인,0,0,1,1
안방에 TV 없음,기타,0,0,1,1
영화 예매,콘텐츠 및 감상,0,0,1,1
영상 시청 추천,사운드 및 영상 품질,1,0,0,1
영화 원작,기타,0,0,1,1
"영화 장르: 드라마, 모험",영화 및 문화,0,0,1,1
안전한 구매,기타,1,0,0,1
영어 공부 계획,추천 및 계획,0,0,1,1
안전결제 옵션,결제 및 구매 관련,0,0,1,1
영화 제목,기타,0,0,1,1
애니에 대한 흥미 감소,기타,0,1,0,1
영화 제목 '스탠 바이 미',영화 및 문화,0,0,1,1
안전거래 권장,거래 및 구매 관련,0,0,1,1
영화 제목 변경,기타,0,0,1,1
안전 택배 제공,배송 및 포장,0,0,1,1
영화 파워레인져스: 더 비기닝,콘텐츠 및 감상,0,0,1,1
애들방에 적합,사용자 경험,1,0,0,1
영화관 같은 경험,영화 관련,1,0,0,1
영화에 대한 많은 사랑,영화 및 문화,1,0,0,1
영화음악 선정곡,영화 및 문화,0,0,1,1
영상통화 및 원격미팅 가능,기타,1,0,0,1
예랑이의 애정,사용 경험 및 후기,1,0,0,1
영상 컨텐츠 시청,제품 특징 및 사용,1,0,0,1
애용하는 가전,가전 및 가구 선택 고민,1,0,0,1
예쁘고 좋음,디자인 및 외관,1,0,0,1
애플 TV 및 애플 뮤직 앱 사용 가능,제품 기능 및 성능,1,0,0,1
안방에서 스탠바이미 사용,사용 환경 및 용도,0,0,1,1
안방에서 사용,제품 적합성 및 사용 장소,1,0,0,1
영상 재생 활용 만족,사용 후기 및 신뢰,1,0,0,1
예쁘고 활용도 좋음,기타,1,0,0,1
영상 재생,제품 기능 및 사용성,1,0,0,1
애플 기기 호환,제품 특성 및 기능,1,0,0,1
안방에 적합,제품 적합성 및 사용 장소,0,0,1,1
우수한 IT 기기,기타,1,0,0,1
아이 영상노출용으로 스탠바이미고 적합성 문의,제품 특징 및 기능,0,0,1,1
신품 선호,제품 상태 및 판매,0,0,1,1
유튜브 검색,화면 및 콘텐츠,0,0,1,1
신혼집 인테리어,기타,1,0,0,1
유용함,사용 용도 및 기능,1,0,0,1
신혼집 인기,제품 특징 및 활용,1,0,0,1
유일무이한 성과,기타,1,0,0,1
신혼집 가전 추천,가전 및 생활,1,0,0,1
신혼집 가전 선택,구매 및 소비,0,0,1,1
유일무이한 이동식 스마트TV,제품 혁신 및 신제품,0,0,1,1
신혼집 가전,기타,0,0,1,1
야외 사용 적합,사용 및 기능,1,0,0,1
야외 시청 가능,이동식 TV 및 포터블 스크린,0,0,1,1
신혼집 가구로 선택,제품 적합성 및 사용 장소,1,0,0,1
신혼집 가구 고민,가전 및 가구 선택 고민,0,0,1,1
신혼집 TV 필요성,가전 및 가구 선택 고민,0,0,1,1
신혼집 TV 선택 고민,제품 특징 및 활용,0,0,1,1
유튜브 및 OTT 시청 패턴,제품 특징 및 사용,0,0,1,1
우수한 사운드,화면 및 사운드,1,0,0,1
신혼집 TV 대체,제품 적합성 및 사용 장소,0,0,1,1
신혼부부에게 적합,제품 구매 및 만족도,0,0,1,1
엘지트윈스 챔피언 에디션 구매,구매 및 할인,0,0,1,1
유튜브 및 웹페이지 속도 느림,제품 성능 및 기능,0,1,0,1
유튜브 배속 가능,콘텐츠 및 감상,1,0,0,1
신혼부부가전 추천,라이프스타일 적합성,1,0,0,1
신혼부부 추천,사용 후기 및 신뢰,1,0,0,1
유튜브 시청 가능,사용 및 설치,1,0,0,1
유튜브 영상,기타,0,0,1,1
유튜브 채널 제공,기타,0,0,1,1
유튜브/SNS에서 접함,기타,0,0,1,1
유튜브/넷플릭스 시청,제품 기능 및 사용,0,0,1,1
신혼부부 고민 제품,가전 및 생활,0,0,1,1
신혼가전패키지에서 구매,기타,0,0,1,1
유용한 스탠바이미,스탠바이미 제품 관련,1,0,0,1
유용한 사용,고객 경험 및 만족도,1,0,0,1
유용한 가전,사용자 경험 및 만족도,1,0,0,1
신혼집 크기,사용 환경 및 용도,0,0,1,1
여러 거래 방법,기타,0,0,1,1
유명한 작품,기타,0,0,1,1
유명한 제품,기타,0,0,1,1
실내외 사용 가능,기타,1,0,0,1
유무선 결합 가입,기능 및 기술,0,0,1,1
유선 및 무선 사용,기능 및 사용,1,0,0,1
유선 불편함,기타,0,1,0,1
유선 연결 불편,연결 및 설치,0,1,0,1
유선의 단점,기타,0,1,0,1
실내 활동 제한,부가 기능 및 기타,0,0,1,1
유아 홈스쿨링 활용,사용 용도 및 기능,1,0,0,1
실내 활동,활용 및 용도,0,0,1,1
실내 이동 편리,캠핑 및 휴대성,0,0,1,1
여러 TV 보유,기타,0,0,1,1
실내 사용 적합,부가 기능 및 기타,1,0,0,1
유압 방식으로 높이 조절 용이,제품 품질 및 디자인,1,0,0,1
유압식 높이 조절 가능,사용자 편의성,1,0,0,1
유연성,기타,0,0,1,1
어린 친구들의 이야기,기타,0,0,1,1
야외 사용 내구성,기타,1,0,0,1
실내 밝기 향상,기타,1,0,0,1
실내 및 야외 사용 가능,편의성과 활용,1,0,0,1
엠베스트 인강 시청 가능 여부,콘텐츠 및 사용성,0,0,1,1
신혼집에 적합,기타,1,0,0,1
신혼집에 TV 비치 여부,기타 기능 및 고민,0,0,1,1
엘픽쇼 실시간 방송,기타,0,0,1,1
유용성 의문,기타,0,0,1,1
신혼집/자취방에 어울리는 디자인,디자인 및 공간 활용,1,0,0,1
엘지티비 50인치,브랜드 및 모델 비교,0,0,1,1
유튜브/영상 시청,기타,1,0,0,1
신혼가전으로 최적,기타,1,0,0,1
엘지트윈스 정규시즌우승버젼,한정판 및 기념품,0,0,1,1
음악 전공 활용,기타,1,0,0,1
신혼 가전으로 추천,추천 및 활용,1,0,0,1
야외 자쿠지 이용 계획,기타,0,0,1,1
엘지스마트티비,브랜드 및 모델 비교,0,0,1,1
엘지베스트샵 준비,기타,1,0,0,1
음악 핸드폰 연결,기타,1,0,0,1
신혼 가전 구매,가전 및 생활,0,0,1,1
음질 우수,기타,1,0,0,1
음질 유용,제품 기능 및 성능,1,0,0,1
신혼 가구,기타,1,0,0,1
신형 휴대폰 비쌈,기타 제품 및 서비스,0,1,0,1
음질 좋음,기타,1,0,0,1
음질 차이,사운드 및 영상 품질,0,0,1,1
음질 최고,사용 및 기능,1,0,0,1
음향 아쉬움,성능 아쉬움,0,1,0,1
응모 방법 간단,마케팅 및 프로모션,1,0,0,1
응모 실패,구매 및 이벤트,0,1,0,1
엘지기사 설치,제품 구성 및 특성,0,0,1,1
응모 참여,기타,0,0,1,1
의류 관리,기타,1,0,0,1
의학 자문,건강 및 안전,1,0,0,1
이광한 DJ,기타,0,0,1,1
이동,기타,0,0,1,1
신형 폰 비쌈,기타,0,1,0,1
영어 영상 노출,기타,0,0,1,1
신형 출시 예정,신제품 및 출시 소식,0,0,1,1
이동 가능한 TV 사용에 대한 초기 의문,이동식 TV 및 포터블 스크린,0,0,1,1
이동 가능한 TV 스탠바이미,기타,0,0,1,1
이동 가능한 무빙 스탠드,제품 특성 및 기능,0,0,1,1
신품급 상태,제품 상태 및 사용,0,0,1,1
신혼 및 입주 가전 추천,구매 및 사용 경험,0,0,1,1
음악 위주 사용,사용 및 기능,0,0,1,1
유튜브/영화/드라마 시청,멀티미디어 기능,1,0,0,1
음악 애호가 추천,음향 및 사운드,1,0,0,1
야외 영화 및 보드 게임 가능,캠핑 및 야외 활동,1,0,0,1
유튜브로 제품 장점 확인,제품 특징 및 활용,0,0,1,1
엘지전자 제품,기타,0,0,1,1
유플러스 모바일 TV 어플로 시청 가능성,제품 활용 및 기능,0,0,1,1
유플러스티비,브랜드 및 모델 비교,0,0,1,1
신혼가전으로 적합,사용 환경 및 장소,1,0,0,1
유해물질 제거,기타,1,0,0,1
유행 타지 않음,기타,1,0,0,1
육아에 유용,기타,1,0,0,1
신혼가전으로 구입,기타,0,0,1,1
은은한 크림컬러,제품 품질 및 디자인,1,0,0,1
음료 및 도너츠 가게 운영,기타,1,0,0,1
엘지전자 스탠바이미 고,기타,0,0,1,1
음성인식,제품 기능 및 성능,0,0,1,1
신혼가전으로 구매,사용 경험 및 후기,0,0,1,1
신혼가전 추천,사용 경험 및 후기,1,0,0,1
신혼가전 선택 고민,TV 구매 및 사용 고민,0,0,1,1
엘지전자 규정,제품 구성 및 특성,0,0,1,1
음악 감상 가능,사용자 경험,1,0,0,1
음악 감상 용도,기타 기능 및 특징,1,0,0,1
신혼가전 구입 고민,구매 및 선택 고민,0,0,1,1
음악 기능,기술 및 기능,0,0,1,1
음악 듣기,사용 용도 및 기능,0,0,1,1
신혼가전 구매,마케팅 및 이벤트,0,0,1,1
신혼가전,기타,0,0,1,1
음악 듣기 좋음,기능 및 성능,1,0,0,1
음악 및 영화 감상 만족,제품 사용 경험 및 평가,1,0,0,1
음악 사랑,기타,1,0,0,1
신혼 생활 활용,구매 및 소비,1,0,0,1
실내외 사용 편리,캠핑 및 휴대성,1,0,0,1
여러 번 시청,기타,0,0,1,1
여러 판매처에서 구매 가능,기타,0,0,1,1
운영체제 기반 작동,운영 및 환경,0,0,1,1
운이 좋음,기타,0,0,1,1
앱 설치 불가,제품 성능 및 기능,0,1,0,1
운치 있는 캠핑장,캠핑 및 야외 활동,1,0,0,1
울트라HD 4K화질,화질 및 화면,0,0,1,1
앱 이용 가능 여부 문의,편리한 조작 및 사용자 경험,0,0,1,1
움직임 감지,기타,0,0,1,1
움직임 중점,기타,0,0,1,1
여행 및 캠핑에 적합,기타,1,0,0,1
아쉬운 점,기타,0,0,1,1
웅장한 존재감,사용자 경험 및 기능,1,0,0,1
원격 수업 및 재택 근무,기타,1,0,0,1
야구 시청,사용 및 기능,0,0,1,1
원격 회의 및 회사 업무,편의성과 활용,0,0,1,1
여행 및 차박에 적합,제품 특성 및 용도,1,0,0,1
야나두 학습지,교육 및 학습,0,0,1,1
여행 경험,기타,0,0,1,1
원격수업,기타,0,0,1,1
여행 가방 형태의 디자인,이동 및 휴대성,0,0,1,1
아버지를 위한 구매,사용자 경험,0,0,1,1
원격수업 가능,제품 특성 및 기능,1,0,0,1
원격수업 활용,기타,1,0,0,1
여행 가방 스타일 케이스,이동식 TV 및 포터블 스크린,0,0,1,1
원룸 사용,기타,0,0,1,1
원목 사용,디자인 및 소재,1,0,0,1
원목 사용으로 감성적,제품 구성 및 특성,1,0,0,1
아모레퍼시픽 매장 설치,기타,0,0,1,1
원스톱 쇼핑 제안,기타,0,0,1,1
원어민 사고 학습법,기타,1,0,0,1
아마존 프라임 비디오,기타,0,0,1,1
아시아 주요 국가 출시,시장 및 출시 전략,0,0,1,1
"아야노 고, 츠마부키 사토시, 쿠로키 메이사, 타마야마 테츠지 출연 영화 2주 연속 2위",영화 관련,0,0,1,1
원조 제품과 비교,제품 특징 및 활용,0,0,1,1
운영 규칙,기타,0,0,1,1
앱 개발 필요,기타,0,0,1,1
앱 반응 속도 느림,제품 성능 및 기능,0,1,0,1
우수한 서브테이블,기타,1,0,0,1
우수한 성능,제품 기능 및 성능,1,0,0,1
우수한 스피커,사운드 및 스피커,1,0,0,1
아이 선물로 구입,기타,0,0,1,1
아이 둘 양육,사용 용도 및 환경,0,0,1,1
우수한 음향,음향 및 스피커,1,0,0,1
아이 교육에 도움,기타,1,0,0,1
우수한 품질,디자인 및 품질,1,0,0,1
아웃도어 활동 적합,제품 내구성 및 휴대성,1,0,0,1
아웃도어 활동,아웃도어 및 캠핑,0,0,1,1
우수한 휴대성,휴대성과 이동성,1,0,0,1
우승기념 판매,한정판 및 기념품,0,0,1,1
앱 부족,기능 및 사용,0,1,0,1
우승할인 가전 세일,가격 및 구매,0,0,1,1
여행에 적합,캠핑 및 이동성,1,0,0,1
우연한 발견,기타,0,0,1,1
우울함 해소,기타,1,0,0,1
여행가방형 케이스,아웃도어 및 캠핑,0,0,1,1
여행 필수품,제품 활용 및 기능,1,0,0,1
아역배우 안전 감시 철저,사회적 이슈 및 트렌드,0,0,1,1
우정과 성장 영화,라이프스타일 및 경험,0,0,1,1
우체국 착불 가능,거래 및 구매 방법,0,0,1,1
우체국택배 착불,배송 및 포장,0,0,1,1
운 좋게 구매,제품 구매 및 결정,1,0,0,1
앱 설치 방법 문의,편리한 조작 및 사용자 경험,0,0,1,1
운동 효과,기능 및 성능,1,0,0,1
운동할 때 편리,사용 환경 및 편리성,1,0,0,1
아마존 가격 확인,가격 및 거래 조건,0,0,1,1
야외 및 여행 중 사용 편리,사용 환경 및 활용,1,0,0,1
유명세,브랜드 및 유명세,0,0,1,1
위아래 조절 가능,사용자 편의성,0,0,1,1
심장 건강,기타,1,0,0,1
실제적인 사운드,사운드 및 스피커,1,0,0,1
실제 후기 부족,기타,0,0,1,1
여유로운 수건 배치,기타,1,0,0,1
여성 가죽 컴포트 슈즈 할인,구매 및 가격 혜택,0,0,1,1
여름에 유용,제품 특성 및 용도,1,0,0,1
실외 실내 사용 방식,사용 환경 및 용도,0,0,1,1
여름날의 끝자락 감성,영화 및 문화,0,0,1,1
실시간 중계 가능,제품 활용 및 기능,1,0,0,1
위치: 은평구,기타,0,0,1,1
위치에 구애받지 않음,기타,0,0,1,1
실시간 TV 및 영상 콘텐츠 사용,기타,0,0,1,1
실사용 적음,제품 상태 및 포장,0,0,1,1
여름과 잘 어울림,기타,1,0,0,1
위험성 우려,기타,0,0,1,1
실사용 시 괜찮은 화질,화질 및 디스플레이,1,0,0,1
실사용 50시간,제품 상태 및 사용,0,0,1,1
여름 캠핑,이동 및 캠핑 활용,0,0,1,1
실사용 3회 미만,제품 상태 및 구성,0,0,1,1
유럽 시장 성공,기타,1,0,0,1
유럽 출시,제품 모델 및 출시,0,0,1,1
유려한 디자인,제품 디자인 및 트렌드,1,0,0,1
유력 매체 찬사,기타,1,0,0,1
실사용 2회,제품 특징 및 사용,0,0,1,1
유명 매체 언급,기타,0,0,1,1
실물이 더 이쁨,제품 상태 및 포장,1,0,0,1
실물 출시 후 리뷰 예정,제품 출시 및 리뷰,0,0,1,1
실물 첫 경험,사용 경험 및 후기,0,0,1,1
실물 영접,기타,0,0,1,1
위치 안내,기타,0,0,1,1
심플하고 세련된 디자인,디자인 및 스타일,1,0,0,1
원하는 장소에서 사용,제품 특징 및 사용성,0,0,1,1
심플한 디자인,디자인 및 외관,1,0,0,1
원하는 장소와 시간에 콘텐츠 즐김,기타,1,0,0,1
원하는 파이 수량: 1752,기타,0,0,1,1
여전히 인기 있는 제품,기타,1,0,0,1
여자에게 무거움,기타,0,1,0,1
웨딩가전,마케팅 및 판매,0,0,1,1
야외 및 캠핑용,캠핑 및 야외 사용,0,0,1,1
여유와 즐거움 제공,제품 평가 및 후기,1,0,0,1
아랫칸 수납 활용,기타,0,0,1,1
웨이브 배속 기능 없음,콘텐츠 및 사용성,0,1,0,1
웨이브 스탠다드 3개월 이용권,이벤트 및 프로모션,0,0,1,1
아들이 좋아함,사용 후기 및 신뢰,1,0,0,1
웨이브 앱 생중계 문제,문제 및 불만,0,1,0,1
아늑한 분위기,기타,1,0,0,1
웨이브 지상파 시청,기타,0,0,1,1
웹OS 탑재,제품 및 기술 사양,0,0,1,1
야외 및 캠핑족을 위한 적합성,활용 및 적합성,1,0,0,1
아기 재운 후 시청,기타,0,0,1,1
아가씨의 아침 책임,기타,0,0,1,1
위버스 DM 미발송,기타,0,1,0,1
씌운 상태로 TV 시청 가능,사용 및 기능,0,0,1,1
위산 역류 및 코막힘 완화,기타,1,0,0,1
쓰레기통,사용 용도 및 환경,0,0,1,1
위시 리스트에 포함,제품 구매 및 결정,0,0,1,1
위시리스트 1위,마케팅 및 이벤트,1,0,0,1
싼 가격,기타,1,0,0,1
싸움과 화해,문화 및 이벤트,0,0,1,1
싱크 문제 없음,제품 기능 및 사용성,1,0,0,1
위시리스트 작성,기타,0,0,1,1
심형탁씨와 관련,기타,0,0,1,1
007가방 같은 디자인,디자인 및 기능,0,0,1,1
주문 후 해피콜 및 카카오톡 알림,구매 과정,0,0,1,1
작은 화면 답답함 해소,기타,1,0,0,1
팬과의 소통,기타,0,0,1,1
판매자 정보 제공,거래 및 구매,0,0,1,1
판매방식 덧글순,거래 및 가격,0,0,1,1
판매가격 65만,거래 및 가격,0,0,1,1
판매 채널,판매 및 거래,0,0,1,1
판매 지역: 남촌동,거래 및 가격,0,0,1,1
판매 지역 송도1동,거래 및 배송 관련,0,0,1,1
판매 지역,제품 상태 및 거래,0,0,1,1
판매 준비 중,시장 및 소비자 반응,0,0,1,1
판매 정보,구매 및 판매 정보,0,0,1,1
판매 위치,제품 상태 및 거래,0,0,1,1
판매 기대,기타,0,0,1,1
판매 결정,부가 정보 및 기타,0,1,0,1
"판매 가격: 700,000원",가격 및 구매,0,0,1,1
파트너스 활동,기타,0,0,1,1
파우치 가방 포함,제품 상태 및 포장,1,0,0,1
파손 주의,기타,0,0,1,1
파손 문제 걱정,내구성 및 안전성,0,1,0,1
파생상품 기대,제품 평가 및 기대,0,0,1,1
파격 할인,가격 및 거래 조건,1,0,0,1
판매자 정보: 이탱TV,기타,0,0,1,1
팔걸이 분리 가능,사용자 경험 및 기능,1,0,0,1
팝업 만족도 조사,기타,0,0,1,1
팝업스토어 방문 체험,이벤트 및 프로모션,0,0,1,1
패키지 구매로 저렴한 가격,제품 구매 및 경제성,1,0,0,1
패키지 구매,기타,0,0,1,1
패밀리세팅,제품 기능 및 연결성,0,0,1,1
패딩 발표 예정,기타,0,0,1,1
패드 장점 결합,기술 및 호환성,1,0,0,1
패널 불량,제품 결함 및 서비스,0,1,0,1
팝업스토어 혜택,제품 출시 및 이벤트,0,0,1,1
팝업스토어 오픈,마케팅 및 판매,0,0,1,1
팝업스토어 개최,제품 만족도 및 홍보,0,0,1,1
팝업 매장,마케팅 및 판매,0,0,1,1
팝업바스켓,사용 용도 및 환경,0,0,1,1
팝업 행사,기타,0,0,1,1
팝업 체험 편리,제품 출시 및 홍보,1,0,0,1
팝업 전시,기타,0,0,1,1
팝업 일정,제품 출시 및 홍보,0,0,1,1
팝업 스토어 이벤트,이벤트 및 프로모션,0,0,1,1
팝업 스토어 개최,제품 만족도 및 홍보,0,0,1,1
팝업 방문,제품 출시 및 이벤트,0,0,1,1
틸트 기능,기타,1,0,0,1
틱톡 사용,문화 및 엔터테인먼트,0,0,1,1
티빙/유튜브 시청,기능 및 연결성,0,0,1,1
특별한 분위기,라이프스타일 및 경험,1,0,0,1
튼튼한 구조,디자인 및 공간 활용,1,0,0,1
튼튼한 거치대,제품 크기 및 구조,1,0,0,1
특허 침해,특허 및 법적 문제,0,1,0,1
특징 정보,제품 정보 및 추천,0,0,1,1
특정 지역 거래,거래 및 판매,0,0,1,1
특이한 제품,제품 디자인 및 구조,0,0,1,1
특이한 디자인,기타,0,0,1,1
특실에 적합,제품 특징 및 활용,1,0,0,1
특별한 무빙 스탠드 디자인,제품 디자인 및 조립,0,0,1,1
튼튼한 제품,제품 내구성 및 성능,1,0,0,1
특별한 공간 마련,특별한 경험 및 기능,1,0,0,1
특별 할인가격,가격 및 구매 정보,0,0,1,1
특가 가격,가격 및 구매,1,0,0,1
트렌디한 디자인,제품 디자인 및 트렌드,1,0,0,1
트렌드 따라서 스탠바이미 선택,제품 출시 및 트렌드,0,0,1,1
트렁크 길이와 불일치,제품 설치 및 이동 문제,0,1,0,1
투자지원금 제공,제품 기대 및 스펙,0,0,1,1
투썸플레이스 스트로베리 초콜릿,기타,0,0,1,1
튼튼한 소재,기타,1,0,0,1
튼튼한 케이스,제품 내구성 및 품질,1,0,0,1
티빙 웨이브 모바일 이용권 호환 여부 궁금,제품 사용 및 기능,0,0,1,1
티비 선택 고민,기타 제품 및 서비스,0,0,1,1
티빙 미러링,미러링 및 연결,0,0,1,1
티빙 리모컨 작동 안됨,기타,0,1,0,1
티비 자주 보는 사람에게 좋음,기타,1,0,0,1
티비 없음으로 인한 심심함 해결,기타,0,0,1,1
티비 없는 생활 시도,특정 상황 및 용도,0,0,1,1
티비 시청 필요,기타 제품 및 서비스,0,0,1,1
티비 시청 만족,기타,1,0,0,1
티비 시청,제품 특성 및 기능,0,0,1,1
티비 브랜드 추천 요청,브랜드 및 모델 비교,0,0,1,1
튼튼한 하드 케이스,기타,1,0,0,1
티비 볼 시간 부족,사용 환경 및 용도,0,0,1,1
티비 및 영화 시청,제품 사용 경험,0,0,1,1
티비 미소유,기타,0,0,1,1
티비 대체 고려,제품 특징 및 활용,0,0,1,1
티비 거치대 사용,편의 및 이동성,0,0,1,1
티몬 몬스터 세일,프로모션 및 이벤트,1,0,0,1
티몬 24개월 무이자 할부,제품 판매 및 혜택,0,0,1,1
튼튼해 보임,기능 및 호환성,1,0,0,1
패키지 출시 기쁨,추천 및 계획,1,0,0,1
팬들의 기대,기타,1,0,0,1
토치,사용 용도 및 환경,0,0,1,1
퍼부어 쌀국수집,기타,0,0,1,1
폴딩 박스 제공,제품 및 액세서리,1,0,0,1
폰을 리모컨처럼 사용,사용자 경험 및 만족도,1,0,0,1
폰앤론 거래,시장 및 경제,0,0,1,1
폭이 좁음,디자인 및 공간 활용,0,1,0,1
포토존,이벤트 및 프로모션,0,0,1,1
포터블 이동식 TV,제품 특징 및 사용,0,0,1,1
포터블 스탠드 TV 소개,기타,0,0,1,1
포터블 스크린 활용,기타,0,0,1,1
포터블 스크린 출시,제품 휴대성과 이동성,0,0,1,1
포터블 스크린 인기,캠핑 및 이동성,1,0,0,1
포터블 스크린 기능,제품 기능 및 성능,0,0,1,1
포터블 스크린 감성,사용 환경 및 용도,1,0,0,1
포터블 불편,스탠바이미 제품,0,1,0,1
포터블 모델과 차이,제품 비교 및 선택,0,0,1,1
포터블 모니터로 분류,기타,0,0,1,1
포터블 디바이스 인기,기타,0,0,1,1
포터블 TV,기타,0,0,1,1
포장상태 양호,제품 상태 및 포장,1,0,0,1
포장 상태 만족,마음의 만족,1,0,0,1
폴딩박스 세트,휴대성과 보관,0,0,1,1
폴라로이드 4K UHD LED TV,제품 비교,0,0,1,1
푸짐한 혜택,소비자 혜택 및 이벤트,0,0,1,1
풍부한 음량,음향 및 사운드,1,0,0,1
프레딧 정구독 장점,마케팅 및 프로모션,0,0,1,1
프레딧 적립금 제공,구매 및 사용 경험,0,0,1,1
프레딧 적립금 3등~5등,기타,0,0,1,1
프라이빗 스크린 혁신,기타,0,0,1,1
프라이빗 스크린 컨셉,제품 기능 및 사용성,0,0,1,1
프라이빗 모니터,기타,0,0,1,1
풍성한 혜택,이벤트 및 혜택,1,0,0,1
풍성한 사운드,사운드 및 음향,1,0,0,1
풍부한 색감,사용자 경험,1,0,0,1
풀 터치 스크린 조작,기능 및 사용 편의성,1,0,0,1
품절대란,기타,0,0,1,1
품절 대란 가능성,구매 및 사용 경험,0,0,1,1
품절 경험,기타,0,0,1,1
풀터치 스크린,제품 기능 및 사용성,0,0,1,1
풀터치,제품 기능 및 디자인,0,0,1,1
풀구성 박스,제품 상태 및 제조 정보,0,0,1,1
풀 화면 시청,기타,1,0,0,1
풀 터치스크린,기능 및 성능,0,0,1,1
포장 상태,제품 상태 및 제조 정보,0,0,1,1
평생학습권,기타,0,0,1,1
평생학습 및 신규 콘텐츠 무료,학습 및 콘텐츠,1,0,0,1
편리한 높낮이 조절,기타,1,0,0,1
편리한 스탠드,사용 편의성,1,0,0,1
편리한 설치 및 철수,기타,1,0,0,1
편리한 사용성,제품 기능 및 사용성,1,0,0,1
편리한 복사 및 붙여넣기,기술 및 기능,1,0,0,1
편리한 목 보호,기타,1,0,0,1
편리한 모니터 사용,다양한 기능 및 설정,1,0,0,1
편리한 렌탈 서비스,기타,1,0,0,1
편리한 디바이스 연결,제품 성능 및 기능,1,0,0,1
편리한 공부,기타,1,0,0,1
편리한 위치,기타,1,0,0,1
편리한 결제,부가 서비스 및 혜택,1,0,0,1
편리한 거치대,제품 기능 및 사용성,1,0,0,1
편리한 가전,디자인 및 스타일,1,0,0,1
편리하고 예쁜 디자인,제품 디자인 및 구조,1,0,0,1
편리성 고민,사용 편의성 및 편리함,0,0,1,1
편견 없는 세상 기여,기타,1,0,0,1
펜션 위치,기타,0,0,1,1
페어링,제품 기능 및 디자인,0,0,1,1
편리한 예약,기타,1,0,0,1
편리한 이용,사용 편의성,1,0,0,1
평생신규컨텐츠 업데이트,기타,0,0,1,1
편안한 시청,제품 사용 경험 및 평가,0,0,1,1
평생 학습권,교육 및 학습,1,0,0,1
평생 무료 영어공부,기타,1,0,0,1
평생 무료 광고하는 비싼 영어 프로그램 피해야 함,가격 및 구매 고려,0,1,0,1
편한 자세로 시청 가능,기타,1,0,0,1
편한 자세로 시청,제품 특징 및 사용성,0,0,1,1
편안한 화면,화질 및 시청 경험,1,0,0,1
편안한 착용감,디자인 및 스타일,1,0,0,1
편안한 이동,기타,1,0,0,1
편안한 스탠다드 핏,기타,1,0,0,1
편리한 자리 설정,사용자 편의 및 기능,1,0,0,1
편안한 생활을 위한 아이템,사용자 경험 및 만족도,1,0,0,1
편안한 디자인,사용자 경험 및 만족도,1,0,0,1
편안한 TV 시청,사용자 경험 및 만족도,0,0,1,1
편안하고 이동이 자유로운 시청 경험,제품 설치 및 사용 환경,1,0,0,1
편리한 휴대,제품 디자인 및 이동성,1,0,0,1
편리한 터치스크린 조작,사용 만족 및 편의성,1,0,0,1
편리한 조작,편리한 조작 및 사용자 경험,1,0,0,1
편리한 제품,기타,1,0,0,1
통화 지연,기타 이슈 및 요구,0,1,0,1
텐트트레일러,사용 용도 및 환경,0,0,1,1
프레딧 정기구독 홍보,부가 서비스 및 혜택,0,0,1,1
크고 튼튼한 스탠드 구매,기타,0,0,1,1
코스트코에서 도라야끼 구매,기타,0,0,1,1
코스트코 할인 행사,구매 및 가격,0,0,1,1
코스트코 추천,추천 및 활용,0,0,1,1
코스트코 구매 전 체험 및 가격 비교 추천,구매 및 사용 경험,0,0,1,1
코스트코 가격,가격 및 구매 고려,0,0,1,1
코로나 조심,기타,0,0,1,1
코로나 19 영향,기타,0,0,1,1
코골이베개로 사용,기타,0,0,1,1
코골이 완화,건강 및 생활,1,0,0,1
코골이 방지,기타,0,0,1,1
케이스 포함,기타,0,0,1,1
케이스 직접 도안,추가 기능 및 혜택,0,0,1,1
케이스 제작 의뢰,디자인 및 개인화,0,0,1,1
케이스 일체형,기타,0,0,1,1
케이스 사용,기타,0,0,1,1
케이블/리모컨 번거로움,사용 편의성,0,1,0,1
컴퓨터 교체,기타,0,0,1,1
컴팩트하고 가벼움,제품 특징 및 사용,1,0,0,1
컬러 괜찮음,개인 사정 및 기타,1,0,0,1
콘솔게임 중 OTT 시청,사용 경험 및 후기,1,0,0,1
콘텐츠 9종 제공,추가 기능 및 혜택,1,0,0,1
콘텐츠 러버 추천,추천 및 활용,1,0,0,1
쿠팡 활동,기타,0,0,1,1
퀴즈,소비자 혜택 및 이벤트,0,0,1,1
퀄리티 좋은 곳,제품 정보 및 추천,0,0,1,1
퀄리티 고려,제품 품질 및 디자인,0,0,1,1
쿠폰 지급,구매 및 가격 혜택,0,0,1,1
쿠팡이츠 추천,기타,0,0,1,1
쿠팡에 제품 정보 부족,기타,0,0,1,1
쿠팡안심케어 보험 옵션,프로모션 및 이벤트,0,0,1,1
쿠팡 활동 수수료,기타,0,0,1,1
쿠팡 핫딜 구매,구매 및 소비자 경험,0,0,1,1
콘텐츠 러버에게 적합,기타,0,0,1,1
쿠팡 파트너스 활동,기타,0,0,1,1
쿠팡 추천,기타,1,0,0,1
쿠팡 보험 옵션,구매 옵션 및 서비스,0,0,1,1
쿠팡 로켓설치 고려,기타,0,0,1,1
쿠팡 구매 가능,결제 및 구매 관련,0,0,1,1
쿠팡 구매,구매 및 판매 관련 이슈,0,0,1,1
쿠션감 지속성,기타,0,1,0,1
쾌적한 온도 유지,특별한 경험 및 기능,1,0,0,1
컨텐츠 수 비교,사용자 경험 및 평가,0,0,1,1
커피교환권 증정,이벤트 및 프로모션,0,0,1,1
커버,기능 및 호환성,0,0,1,1
캠핑장에서 인기,캠핑 및 휴대성,1,0,0,1
캠핑족 추천,사용 환경 및 활용,1,0,0,1
캠핑족 입소문,캠핑 및 야외 활동,1,0,0,1
캠핑족 사이 인기,캠핑 및 휴대성,1,0,0,1
캠핑족 만족,제품 환영 및 만족,1,0,0,1
캠핑족 대상,캠핑 및 야외 활용,0,0,1,1
캠핑족,아웃도어 및 캠핑,0,0,1,1
캠핑장에서 편안한 시청,사용 환경 및 활용,1,0,0,1
캠핑장에서 충전 가능 여부,제품 특징 및 사용,0,0,1,1
캠핑장에서 와이파이 약함,캠핑 및 야외 활동,0,1,0,1
캠핑족 필수품,이동 및 캠핑 활용,1,0,0,1
캠핑장에서 시간 빠르게 지나감,기타,0,0,1,1
캠핑장에서 스탠바이미고 사용,캠핑 및 휴대성,1,0,0,1
캠핑장에서 스탠바이미 사용,제품 특징 및 활용,0,0,1,1
캠핑장에서 사용 안함,기타,0,1,0,1
캠핑장에서 사용 불편,사용 환경 및 용도,0,1,0,1
캠핑장에서 사용 기대,사용 환경 및 장소,1,0,0,1
캠핑장에서 분위기 조성,사용 환경 및 활용,1,0,0,1
캠핑장에서 멀티미디어 즐길거리,캠핑 및 야외 활용,0,0,1,1
캠핑족 취향 저격,캠핑 및 야외 활동,1,0,0,1
캠핑족에게 어필,아웃도어 및 캠핑,1,0,0,1
커뮤니티 운영,기타,0,0,1,1
캠핑카여행,사용 용도 및 환경,0,0,1,1
커다란 스피커,제품 기능 및 성능,1,0,0,1
커다란 벽티비 vs 이동 가능한 스탠바이미 고민,사용 및 설치 환경,0,0,1,1
캠핑퍼스트 회원 특별 혜택,프로모션 및 이벤트,0,0,1,1
캠핑티비로 알려짐,캠핑 및 야외 활동,0,0,1,1
캠핑티비로 스탠바이미 추천,특정 사용자 및 활용 사례,1,0,0,1
캠핑트레일러,사용 용도 및 환경,0,0,1,1
캠핑템으로 인기,활용 및 용도,0,0,1,1
캠핑템 추천,캠핑 및 휴대성,0,0,1,1
캠핑카 외부 TV 없음,제품 특성 및 용도,0,0,1,1
캠핑족에게 좋은 반응,이동 및 캠핑 활용,1,0,0,1
캠핑카 여행에서 사용,이동 및 휴대성,1,0,0,1
캠핑카 TV,이동 및 캠핑 활용,0,0,1,1
캠핑카,사용 용도 및 환경,0,0,1,1
캠핑짐과 함께 싣기 어려움,설치 및 이동성,0,1,0,1
캠핑족이 아니라 사용 빈도 낮음,캠핑 및 외부 활동,0,0,1,1
캠핑족을 위한 제품,캠핑 및 야외 활동,1,0,0,1
캠핑족을 위한 TV,사용 환경 및 용도,0,0,1,1
캠핑족에게 추천,캠핑 및 야외 활동,1,0,0,1
퀴즈 문제,기타,0,0,1,1
크기에 놀람,사용 환경 및 설치,0,0,1,1
텐트캠핑,사용 용도 및 환경,0,0,1,1
크기와 무게,기타,0,0,1,1
터치 실행,기능 및 사용,1,0,0,1
터치 스크린 지원,기능 및 기술,1,0,0,1
터치 스크린 조작,사용자 편의성,1,0,0,1
터치 및 리모컨 컨트롤 가능,사용자 편의 및 기능,1,0,0,1
터치 모니터,기타,0,0,1,1
터치 기능 편리,스탠바이미 제품 관련,1,0,0,1
터치 가능성,제품 특징 및 활용,0,0,1,1
탭 연결,기타,1,0,0,1
탭 미러링 연결,이동식 TV 및 포터블 스크린,0,0,1,1
택시비 네고,가격 및 거래 조건,0,0,1,1
택배비 추가,거래 및 배송,0,0,1,1
택배비 별도,가격 및 거래,0,0,1,1
택배 거래 불가,거래 및 구매 방법,0,1,0,1
태블릿으로 영어공부,기타,0,0,1,1
태블릿으로 배속 설정,콘텐츠 및 사용성,0,0,1,1
태블릿 및 콘텐츠 증정,기타,1,0,0,1
태블릿 대용 가능,기타,1,0,0,1
태블릿 거치대 필요,제품 특성 및 기능,0,0,1,1
탐나는 가전,제품 혁신 및 신제품,1,0,0,1
터치 연결,기능 및 성능,0,0,1,1
터치 조작 가능,편의성과 활용,0,0,1,1
터치 조작 기능,제품 기능 및 디자인,0,0,1,1
테라스 라이프,제품 활용 및 기능,0,0,1,1
텐트 사용,사용 환경 및 장소,0,0,1,1
테이블모드 신박함,사용자 경험,1,0,0,1
테이블 색상 및 크기 적합,제품 품질 및 디자인,1,0,0,1
테이블 및 거치대 선택 어려움,제품 특징 및 구성,0,0,1,1
테이블 다리 약함,기타,0,1,0,1
테스트용 1회 사용,제품 상태 및 포장,0,0,1,1
테라스 정원,제품 활용 및 기능,0,0,1,1
테라스 인테리어,제품 활용 및 기능,0,0,1,1
턴테이블과 유사한 외관,디자인 및 공간 활용,0,0,1,1
터치 지원,기능 및 사용 편의성,1,0,0,1
턴테이블 모드,제품 디자인 및 구조,0,0,1,1
턴테이블 느낌,제품 디자인 및 구조,1,0,0,1
터치식 화면,다양한 기능 및 설정,1,0,0,1
터치스크린으로 다양한 콘텐츠 즐김,기술 및 기능,1,0,0,1
터치스크린 조작,기능 및 호환성,1,0,0,1
터치스크린 대체,기타,0,0,1,1
터치로 인한 지저분한 액정,제품 내구성 및 품질,0,1,0,1
터치 컨트롤 직관적,기능 및 성능,1,0,0,1
탈취 효과,기타,1,0,0,1
탈부착스트랩,제품 및 액세서리,0,0,1,1
탄탄한 디자인,디자인 및 구조,1,0,0,1
큰 TV를 둘 수 없는 공간에서 사용,기타,0,0,1,1
큰 실망,제품 불만 및 실망,0,1,0,1
큰 스크린 설치 어려움,제품 특징 및 활용,0,0,1,1
큰 사건 경험,문화 및 이벤트,0,0,1,1
큰 박스 사이즈,기타 이슈 및 요구,0,0,1,1
큰 박스 배송,이동 및 설치 용이성,0,0,1,1
큰 박스,부가 기능 및 기타,0,0,1,1
큰 모니터로 확장 가능,기능 및 기술,0,0,1,1
큰 노트북 같은 느낌,제품 특징 및 비교,0,0,1,1
큰 TV 치우고 스탠바이미 사용 계획,제품 특징 및 활용,0,0,1,1
큰 인기,제품 만족도 및 인기,1,0,0,1
큰 TV 없애는 것에 대한 아쉬움,제품 특징 및 활용,0,1,0,1
큰 TV 소유,제품 설치 및 사용 환경,0,0,1,1
크지 않은 화면,기타,0,0,1,1
크리스마스 시즌,기타,0,0,1,1
크리스마스 선물 추천,고객 만족 및 리뷰,1,0,0,1
크리스 챔버스 역,영화 및 문학 관련,0,0,1,1
크래쉬배기지 루나 캐리어 포함,기타,0,0,1,1
크래쉬배기지 루나 캐리어,기타,0,0,1,1
큰 아이패드와 유사,기타,0,0,1,1
큰 태블릿,제품 기능 및 사양,0,0,1,1
탁월한 화질,제품 내구성 및 성능,1,0,0,1
큰방에 TV 추가 고민,TV 구매 및 사용 고민,0,0,1,1
탁월한 화면 품질,제품 성능,1,0,0,1
탁월한 음향 시스템,제품 기능 및 성능,1,0,0,1
탁월한 디자인,디자인 및 혁신,1,0,0,1
타이베이 항공권 저렴,기타,1,0,0,1
키퍼 서덜랜드 출연,영화 및 문화,0,0,1,1
키테레츠 대백과 등장인물,기타,0,0,1,1
키오스크 개념 TV,제품 기능 및 디자인,0,0,1,1
큰방에 추가 TV 필요,사용자 경험,0,0,1,1
큰 화면으로 콘텐츠 시청,기타,1,0,0,1
큰 태블릿 느낌,기타,1,0,0,1
큰 화면으로 영상통화,편의성과 활용,1,0,0,1
큰 화면으로 시원한 시청,사용자 경험 및 만족도,1,0,0,1
큰 화면으로 게임 즐김,기타,1,0,0,1
큰 화면에서 작은 화면으로 전환 고민,제품 기능 및 성능,0,0,1,1
큰 화면과 화질 고민,기타,0,0,1,1
큰 화면 감상,기타,1,0,0,1
큰 포장박스,기타,0,0,1,1
큰 티비로 시청,기타,0,0,1,1
프레딧 정기구독,추가 서비스 및 경품,0,0,1,1
프레딧 정기배송,기타,0,0,1,1
작은 화면 불편 여부,제품 특징 및 비교,0,0,1,1
화질 좋음,성능 및 기술,1,0,0,1
화면 전체 회전 가능,제품 기능 및 연결성,1,0,0,1
화면 자유로운 이동,기능 및 성능,1,0,0,1
화면 이용 용이,제품 활용 및 기능,1,0,0,1
화면 이동 가능,제품 기능 및 성능,0,0,1,1
화면 위치,구성 및 설치,0,0,1,1
화면 연결,기타,0,0,1,1
화면 세로 회전 가능,사용자 경험 및 기능,1,0,0,1
화면 사이즈 만족,사용자 경험,1,0,0,1
화면 변형 가능,기타,0,0,1,1
화면 방향 및 각도 조절,스탠드 및 화면 조절,0,0,1,1
화면 미러링 가능,기능 및 호환성,1,0,0,1
화면 모드,멀티미디어 기능,0,0,1,1
화면 들어 올리기 쉬움,휴대성과 이동성,1,0,0,1
화면 높이 조절,스탠드 및 화면 조절,0,0,1,1
화면 공유 활용성,기타,1,0,0,1
화면 공유 차이,기타,0,0,1,1
화면 공유 가능,기술 및 기능,0,0,1,1
화면 공유,기능 및 성능,1,0,0,1
화면 각도에 따른 음향 변화,제품 기능 및 사용성,0,0,1,1
화면 전환,사용 경험,1,0,0,1
화면 전환 가능,제품 사용 및 기능,1,0,0,1
화면 조절 편리,제품 활용 및 기능,1,0,0,1
"화면, 스탠드, 스피커, 내장 배터리",제품 호환 및 액세서리,0,0,1,1
화질 불만족,사용자 경험 및 평가,0,1,0,1
화질 불만,제품 기능 및 사양,0,1,0,1
화이트 와인 추천,건강 및 생활,1,0,0,1
화요일 거래 가능,가격 및 거래,0,0,1,1
화상회의 가능,제품 기능 및 성능,0,0,1,1
화상 회의 및 온라인 수업 활용,활용 및 적합성,1,0,0,1
화사한 배경화면,기타,1,0,0,1
화면공유 방식 차이,기타,0,0,1,1
"화면, 스탠드, 스피커 탑재",기능 및 성능,1,0,0,1
화면 크기 고민,제품 특징 및 비교,0,0,1,1
화면 포함,이동식 TV 및 포터블 스크린,0,0,1,1
화면 터치 기능,기능 및 사용성,0,0,1,1
화면 터치 가능,기타,1,0,0,1
화면 크기 의문,제품 디자인 및 크기,0,0,1,1
화면 크기 아쉬움,화면 및 사운드,0,1,0,1
화면 크기 선택 고민,제품 비교 및 선택,0,0,1,1
화면 크기 불편,제품 특징 및 사용성,0,1,0,1
화면 크기 대안,스탠바이미 제품,0,0,1,1
화면 각도 조절,제품 성능 및 기능,0,0,1,1
홍콩여행 음료 VLT레몬티,기타,0,0,1,1
홍보용 대형스크린,제품 만족도 및 홍보,0,0,1,1
혼수 가전 구매,가전 및 가구 선택 고민,0,0,1,1
혼자만의 시간 활용,고객 만족 및 리뷰,0,0,1,1
혼자 설치 어려움,제품 설치 및 이동 문제,0,1,0,1
혼자 붙이기 어려움,기타,0,1,0,1
혼자 보는 TV,기타,1,0,0,1
혼수가전 필수 품목,기타,1,0,0,1
혼수/입주/이사 가전,구성 및 설치,0,0,1,1
혼수 고민,구매 고려 및 비교,0,0,1,1
혼수 가전 선택 고민,기타,0,0,1,1
혼다 자동차 시승 이벤트,이벤트 및 혜택,0,0,1,1
홀가분한 느낌,사용 편의성 및 편리함,1,0,0,1
호환 인기,기타,0,0,1,1
호환 TV 모니터,기술 및 기능,0,0,1,1
호평,기타,1,0,0,1
호소력 짙은 목소리,기타,1,0,0,1
호불호 갈림,기타,0,0,1,1
호기심 주의,기타,0,0,1,1
호기심 구매,제품 사용 경험 및 평가,0,0,1,1
협박처럼 느껴짐,제품 개선 및 아쉬움,0,1,0,1
혼펜요가,기타,0,0,1,1
홀딩 전략,기타 기능 및 옵션,0,0,1,1
홍보 및 팜플렛 재생 유용,기타,1,0,0,1
홈씨네마,제품 기능 및 성능,0,0,1,1
홈트용으로 사용 가능,제품 기능 및 성능,1,0,0,1
홈트레이닝 사용 재미,사용 및 활용,1,0,0,1
홈트레이닝,건강 및 생활,0,0,1,1
홈트 운동 메이트,사용 용도 및 기능,0,0,1,1
홈캠핑 분위기 업,사용자 경험,1,0,0,1
홈캠핑 무드,라이프스타일 및 경험,1,0,0,1
홈카페 인테리어 개선,디자인 및 인테리어,1,0,0,1
홈앤맘 프로모션,프로모션 및 이벤트,0,0,1,1
홈스쿨 영상 시청,사용 환경 및 활용도,1,0,0,1
홈 라이프 스크린,기타,0,0,1,1
홈쇼핑 혜택 기대,판매 및 마케팅,0,0,1,1
홈쇼핑 혜택,결제 및 구매 관련,0,0,1,1
홈쇼핑 단독 런칭,프로모션 및 이벤트,0,0,1,1
홈쇼핑 구매,가격 및 구매,0,0,1,1
홈 캠핑,특정 사용자 및 활용 사례,1,0,0,1
홈 월페이퍼 이미지 변경,기타,0,0,1,1
홈 엔터테인먼트 경험,제품 평가 및 후기,0,0,1,1
홈 라이프스타일 영상 즐김,사용자 경험 및 기능,1,0,0,1
화질 아쉬움,기능 및 성능,0,1,0,1
화질 프로세서 세대 차이,기능 및 호환성,0,0,1,1
현장 구매 혜택,이벤트 및 혜택,0,0,1,1
확장되는 컨텐츠,제품 활용 및 기능,1,0,0,1
흠집 방지,외관 및 디자인,0,0,1,1
흠집 방어력 증가,기타,1,0,0,1
휴식 시간 즐거움,사용 사례 및 추천,1,0,0,1
휴대하기 편리한 사이즈,이동성과 휴대성,1,0,0,1
휴대하기 적합한 크기,휴대성과 이동성,1,0,0,1
휴대폰 화면 연동,기타,0,0,1,1
휴대폰 연동,제품 기능 및 성능,0,0,1,1
휴대폰 미러링 가능,기타,1,0,0,1
휴대폰 결제 멤버십 신규 가입 혜택,마케팅 및 프로모션,0,0,1,1
휴대용모니터,캠핑 및 휴대성,0,0,1,1
휴대용TV,캠핑 및 휴대성,0,0,1,1
휴대용 포터블 모니터,기타,0,0,1,1
휴대용 포터블 TV,기타,0,0,1,1
휴대용 티비,사용 환경 및 용도,0,0,1,1
휴대용 이동식 TV,이동성과 휴대성,0,0,1,1
휴대용 야외용 캠핑 TV,제품 특징 및 사용,0,0,1,1
휴대용 사용,사용 용도 및 적합성,0,0,1,1
휴대용 모니터 장점,제품의 장점 및 추천,1,0,0,1
휴대용 모니터 이상의 기능,제품 기능 및 디자인,1,0,0,1
흥미로운 제품 다양성,기타,1,0,0,1
"희망 가격 800,000원",거래 및 가격,0,0,1,1
"희망 가격: 800,000원",가격 및 비용,0,0,1,1
힐링 테마,기타,0,0,1,1
힙한 공간,기타,1,0,0,1
힘들게 준비,기타,0,0,1,1
힐링테마 재생,기타,1,0,0,1
힐링테마,사용자 경험 및 만족도,1,0,0,1
힐링쉴드 올레포빅 고광택 보호필름,기타,0,0,1,1
힐링쉴드 보호필름 추천,기타,1,0,0,1
힐링되는 음악 재생,기타,1,0,0,1
힐링 테마모드,사용자 경험 및 기능,0,0,1,1
힐링 공간,기타,1,0,0,1
희망 거래 방법 직거래,기타,0,0,1,1
힐링,제품 특성 및 용도,1,0,0,1
히트작,기타,1,0,0,1
히든 바퀴로 인테리어 유지,제품 품질 및 디자인,1,0,0,1
흰색 모니터 및 스탠드,제품 디자인 및 기능,0,0,1,1
"희망 판매가격 1,000,000원",구매 및 가격 고민,0,0,1,1
희망 거래 지역 장군면,거래 및 배송 관련,0,0,1,1
희망 거래 지역 역삼1동,거래 및 배송,0,0,1,1
희망 거래 방법: 직거래,거래 및 판매 관련,0,0,1,1
휴대용 디자인,디자인 및 외관,1,0,0,1
휴대용 디스플레이,제품 휴대성과 이동성,0,0,1,1
휴대용 TV 전용 수납케이스,기타,0,0,1,1
활용성,기타,0,0,1,1
후면패널 색상,디자인 및 인테리어,0,0,1,1
후면 스피커,제품 기능 및 디자인,0,0,1,1
효과성 좋음,콘텐츠 및 사용성,1,0,0,1
획기적인 제품,기타,1,0,0,1
회전 기능,제품 기능 및 성능,0,0,1,1
회의용 책상 활용,디자인 및 공간 활용,0,0,1,1
회사 행사 당첨,추천 및 계획,1,0,0,1
회 추천,기타,1,0,0,1
활용법,사용 사례 및 추천,0,0,1,1
후속작 출시,기타,0,0,1,1
활용도,제품 특징 및 활용,0,0,1,1
활용 방안,고객 경험 및 리뷰,0,0,1,1
활용 방법 차이,기타,0,0,1,1
활용 가능,사용 용도 및 기능,1,0,0,1
환영 인사 음악,특별한 경험 및 기능,1,0,0,1
환불 고려,사용자 경험 및 평가,0,1,0,1
환불,거래 및 구매 관련,0,1,0,1
환경 기여,에너지 및 환경,1,0,0,1
후속 버전 출시 소식 없음,신제품 및 출시 소식,0,1,0,1
후지코 F 후지오 탄생 80주년 기념,기타,0,0,1,1
휴대성과 편의성,기타,1,0,0,1
휴가철에 적합한 이동식 TV,사용 환경 및 용도,1,0,0,1
휴대성과 성능의 조화,제품 성능 및 기능,1,0,0,1
휴대성과 가벼움,휴대성과 이동성,1,0,0,1
휴대성 초점,라이프스타일 및 경험,1,0,0,1
휴대성 좋음,이동 및 휴대성,1,0,0,1
휴대성 부족,공간 및 휴대성 문제,0,1,0,1
휴대성 고려한 설계,이동 및 설치,1,0,0,1
휴대 적합한 크기,이동식 TV 및 포터블 스크린,1,0,0,1
휴대 가능한 엔터테인먼트,기타,0,0,1,1
휴가 계획 취소로 판매,구매 및 판매 관련 이슈,0,0,1,1
후지코 F. 후지오의 작품,문화 및 엔터테인먼트,0,0,1,1
휠 장착,제품 기능 및 디자인,0,0,1,1
휘게포레스트 만족,제품 환영 및 만족,1,0,0,1
훌륭한 제품,제품 만족도 및 홍보,1,0,0,1
훌륭한 디자인,디자인 및 기능,1,0,0,1
훌륭한 기능,기타,1,0,0,1
후회 없음,제품 만족도 및 인기,1,0,0,1
후회 없는 상품,제품 특성 및 기능,1,0,0,1
후회 가능성,사용 경험 및 후기,0,1,0,1
현재 제품 할인 구매 고민,가격 및 거래,0,0,1,1
현실감 있는 시청,제품 활용 및 기능,1,0,0,1
프레딧 추천인코드,마케팅 및 프로모션,0,0,1,1
할인 적용 가능,기타,0,0,1,1
한정 수량 완판,구매 과정,1,0,0,1
한정 수량 사은품,가격 및 구매,0,0,1,1
한정 생산,기타,0,0,1,1
한정 상품,제품 특징 및 구성,0,0,1,1
한적한 분위기,라이프스타일 및 경험,1,0,0,1
한옥과 어울리는 오브제,디자인 및 인테리어,1,0,0,1
한달 전 구매,제품 구매 및 거래,0,0,1,1
한달 사용 후기,기타,0,0,1,1
한글 자막 사용,콘텐츠 및 감상,0,0,1,1
한국에서 제품 구매 가능 여부 문의,기타,0,0,1,1
한국에서 구매 가능 여부,기타,0,0,1,1
한국 개봉 결정,문화 및 이벤트,0,0,1,1
한 번 사용,제품 상태 및 사용,0,0,1,1
한 달 고민 후 구매,구매 과정,0,0,1,1
학습지 제공,기타,1,0,0,1
학습지 기능,추가 기능 및 혜택,0,0,1,1
학습 관리 기능,다양한 기능 및 설정,1,0,0,1
하프스터디와 시너지 효과 기대,브랜드 및 홍보,1,0,0,1
하프스터디 프로그램 개수 및 업데이트,이벤트 및 프로모션,0,0,1,1
한정 판매 광고,구매 및 이벤트,0,1,0,1
한정된 예산,기타,0,0,1,1
한정수량,기타,0,0,1,1
할부 옵션,제품 구매 및 가격,1,0,0,1
할인 이벤트,가격 및 렌탈,0,0,1,1
할인 여부,기타,0,0,1,1
할인 상품,제품 정보 및 혜택,0,0,1,1
할인 상담 가능,마케팅 및 판매,0,0,1,1
할인 및 최저가 구매,제품 정보 및 혜택,1,0,0,1
할인 구매,가격 및 경제성,0,0,1,1
할인 검색 결과,기타,0,0,1,1
할인 가능성,구매 및 할인,0,0,1,1
할부 구매,구매 및 가격 고민,0,0,1,1
한정수량 타임딜 행사,구매 및 판매 정보,0,0,1,1
할부 vs 일시불,가격 및 거래,0,0,1,1
한정판 판매,기타,0,0,1,1
한정판 스탠바이미고 챔피언 에디션 판매,제품 특징 및 구성,0,0,1,1
한정판 미개봉,구매 및 판매 정보,0,0,1,1
한정판 굿즈,소비자 혜택 및 이벤트,0,0,1,1
한정판 구매 고민,구매 및 이벤트,0,0,1,1
한정판 300대 한정제품,한정판 및 기념품,0,0,1,1
한정수량 판매,제품 구매 및 결정,0,0,1,1
하프스터디 평생 영어 학습기,교육 및 학습,1,0,0,1
하프스터디 최초 어학기 회사,교육 및 학습,0,0,1,1
하프스터디 이벤트,특별한 경험 및 기능,0,0,1,1
프리뷰 모니터 필요,기타,0,0,1,1
필름 부착 후 만족,제품 불만 및 문제,1,0,0,1
필름 부착 서비스,기타,0,0,1,1
픽업 편리,기타,1,0,0,1
피크닉용품,캠핑 및 야외 활동,0,0,1,1
플스5 구매 고려,기타,0,0,1,1
플스 게임 사용,제품 기능 및 성능,1,0,0,1
플레이스테이션5,기타,0,0,1,1
프리즘 HD LED TV,제품 비교,0,0,1,1
프리미엄 요금제 할인,가격 및 경제성,0,0,1,1
필수 가전,사용자 경험 및 만족도,1,0,0,1
프리미엄 사운드 경험,제품 사용 경험 및 평가,1,0,0,1
프로야구 우승 기념 로고,이벤트 및 홍보,0,0,1,1
프로바이오틱스와 비타민C 함유,건강 및 생활,1,0,0,1
프로모션 추천,프로모션 및 이벤트,1,0,0,1
프로그램 수 제한,설치 및 사용 불편,0,0,1,1
프로그램 소개,기타,0,0,1,1
프레이스테이션5 제공,제품 기대 및 스펙,0,0,1,1
프레딧 회원 필요,기타,0,0,1,1
필름 필요,제품 기능 및 사용성,0,0,1,1
필수 가전 아님,기타 기능 및 고민,0,0,1,1
하프스터디 영어공부,기타,1,0,0,1
하드웨어 완성도,기타,1,0,0,1
하프스터디 신청 시 스탠바이미 제공,기타,0,0,1,1
하프스터디 스탠바이미 제공,스탠바이미 및 스마트 모니터 관련,0,0,1,1
하프스터디 선택,기타,0,0,1,1
하프스터디 결합 구매,추천 및 계획,0,0,1,1
하프스터디 2024,교육 및 학습,0,0,1,1
하트라이브,기타,0,0,1,1
하자 확인,서비스 및 지원,0,0,1,1
하드케이스로 파손 걱정 없음,내구성 및 안전성,1,0,0,1
하단부 디스플레이,기타,0,0,1,1
필수 가전제품과 함께 스탠바이미 구매,제품 구매 및 만족도,0,0,1,1
하단 부분 스크레치,제품 디자인 및 기능,0,1,0,1
하단 무빙휠,제품 디자인 및 이동성,1,0,0,1
필요하지 않음,사용 경험 및 후기,0,0,1,1
필요성 의문,기타,0,0,1,1
필요 없음으로 판매,기타,0,0,1,1
필요 없음,기타,0,0,1,1
필수 아이템,사용 사례 및 추천,1,0,0,1
필수 구매,기타,1,0,0,1
할인 적용,기타,0,0,1,1
할인 정보 불확실,제품 구매 및 가격,0,0,1,1
현명한 소비 권장,구매 및 소비,0,0,1,1
할인 코드 및 결제 방식,이벤트 및 프로모션,1,0,0,1
헤븐 게임 오픈,기타,0,0,1,1
헤드셋 두개 연결 가능,기타 기능 및 옵션,0,0,1,1
허리베개 색상,기타,0,0,1,1
허리 건강 문제,건강 및 안전,0,0,1,1
허니뷰 가입,구매 및 사용 경험,0,0,1,1
향수 자극,기타,0,0,1,1
향상된 휴대성,사용 만족 및 편의성,1,0,0,1
향상된 이동성,사용 만족 및 편의성,1,0,0,1
향상된 스피커 출력,제품 내구성 및 성능,1,0,0,1
향상된 색감과 디테일,제품 기능 및 기술,0,0,1,1
행사장 스마트스크린 용도,기타,0,0,1,1
행사용 TV,기타,0,0,1,1
행사가,구매 및 가격 혜택,0,0,1,1
행사 혜택,기타,0,0,1,1
행사 이벤트,기타,0,0,1,1
행사 및 컨퍼런스 적합,기타,1,0,0,1
행사 및 강연에 효과적,활용 및 적합성,1,0,0,1
행사 가격,프로모션 및 이벤트,0,0,1,1
행복한 저녁 시청,사용자 경험,1,0,0,1
헬로렌탈 가격,제품 구매 및 가격,0,0,1,1
헬리녹스 프리스타일 미개봉 제품 판매,제품 교환 및 거래,0,0,1,1
혁신,제품 사용 경험 및 평가,0,0,1,1
혁신적인 포터블 TV,제품 기능 및 사용성,1,0,0,1
현대적인 캠핑 경험,캠핑 및 야외 활용,1,0,0,1
현대적 디자인,기타,0,0,1,1
현대물,기타,0,0,1,1
현대 제휴 결제 가능,가격 및 결제 옵션,0,0,1,1
현금영수증 가능,부가 서비스 및 결제,0,0,1,1
혁신적인 휴대용 디스플레이,디자인 및 스타일,1,0,0,1
혁신적인 홈 제품,긍정적 평가,0,0,1,1
혁신적인 홈 엔터테인먼트 솔루션,제품 정보 및 추천,1,0,0,1
혁신적인 특징,제품 특징 및 기능,1,0,0,1
혁신상 수상,기타,1,0,0,1
혁신적인 터치스크린 TV,기능 및 기술,1,0,0,1
혁신적인 전자제품,제품 혁신 및 신제품,1,0,0,1
혁신적인 이동식 엔터테인먼트 솔루션,캠핑 및 외부 활용,1,0,0,1
혁신적인 엔터테인먼트 기기,제품 및 모델 비교,1,0,0,1
혁신적인 모니터,디자인 및 기능,0,0,1,1
혁신적인 가전 시장 주도,라이프스타일 및 경험,1,0,0,1
혁신적인 TV 개념,제품 특성 및 디자인,0,0,1,1
혁신적 업그레이드,혁신 및 업그레이드,1,0,0,1
행복,제품 만족도 및 홍보,1,0,0,1
행동 분석,구매 및 소비자 반응,0,1,0,1
핸드폰 화면 연결,기타,0,0,1,1
할인행사,구매 및 가격 혜택,0,0,1,1
핫한 가전,기타,0,0,1,1
핫딜정보,가격 및 거래,0,0,1,1
핫딜 여부,사용자 경험,0,0,1,1
핫딜 기대,기타,0,0,1,1
핫딜 기다림,구매 및 거래,0,0,1,1
핫딜 공유,거래 및 구매,0,0,1,1
합의 없이 구매,기타,0,0,1,1
합리적인 제품,기타,0,0,1,1
할인판매 소식,구매 및 거래,0,0,1,1
핫한 아이템,기타,1,0,0,1
할인판매,기타,0,0,1,1
할인가 변동,가격 및 할인,0,0,1,1
할인가 구매,가격 및 구매,1,0,0,1
할인가,구매 및 가격 혜택,0,0,1,1
할인 품목 검색,기타,0,0,1,1
할인 판매,가격 및 구매,0,0,1,1
할인 쿠폰 제공,이벤트 및 프로모션,1,0,0,1
할인 쿠폰 및 카드 할인,기타,1,0,0,1
핫한 상품,제품 평가 및 기대,1,0,0,1
핫한 전자기기 사용,기타,0,0,1,1
핸드폰 연결로 영상 감상 및 모니터 활용,기타,1,0,0,1
해외택배 방법 설명,배송 및 수령,0,0,1,1
핸드폰 연결,제품 기능 및 성능,1,0,0,1
핸드폰 시청,기타,0,0,1,1
핸드폰 사용의 불편함,제품 상태 및 관리,0,1,0,1
핸드폰 사용 불편,기타,0,1,0,1
핸드폰 기능 활용,기술 및 기능,0,0,1,1
핸드폰 거치대 포함,기타,0,0,1,1
해킹 급증,기타,0,1,0,1
해지 시 가격 반납 및 위약금,기타,0,1,0,1
해외택배 방법,기타,0,0,1,1
핫한 포터블 스크린,제품 휴대성과 이동성,1,0,0,1
해외에서의 인기,제품 만족도 및 인기,1,0,0,1
해외 출시 준비,시장 및 소비자 반응,0,0,1,1
해외 출시 예정,시장 및 소비자 반응,0,0,1,1
해외 여행 준비물,사용 환경 및 용도,0,0,1,1
해외 시장 공략,시장 및 출시 전략,0,0,1,1
해시태그 안내,기타,0,0,1,1
해상도,제품 기능 및 사양,0,0,1,1
항산화,건강 및 생활,1,0,0,1
캠핑장에서 높은 화질,캠핑 및 야외 활용,1,0,0,1
캠핑장비로 적합,캠핑 및 야외 활동,1,0,0,1
캠핑장 분위기 조성,사용 용도 및 적합성,1,0,0,1
주방에서 시청 가능,사용 환경 및 용도,1,0,0,1
좋은 노래,기타,1,0,0,1
좋은 날씨,기타,1,0,0,1
좋은 기능,다양한 기능 및 설정,1,0,0,1
좋은 TV,기타,1,0,0,1
좋아하는 영화,영화 및 문화,1,0,0,1
좁은 공간에서 사용,다양한 사용 환경,0,0,1,1
좁은 공간에 적합,다양한 사용 환경,1,0,0,1
좁은 공간에 쉽게 보관,휴대성과 보관,1,0,0,1
좁은 공간에 보관 용이,제품 내구성 및 휴대성,1,0,0,1
좁은 공간 활용,제품 적합성 및 사용 장소,1,0,0,1
좁은 공간 적합,활용 및 적합성,1,0,0,1
"졸업, 전시, 박람회 등 다양한 행사 지원",기타,0,0,1,1
조절식 스탠드 설정 가능,스탠드 및 설치 관련,0,0,1,1
조절 가능한 스탠드,스탠드 및 화면 조절,1,0,0,1
조작 편의성,다양한 기능 및 설정,1,0,0,1
조작 문제 없음,사용자 경험 및 만족도,1,0,0,1
조용한 위치,장소 및 분위기,1,0,0,1
조식,기타,0,0,1,1
조말론 핸드크림 경품,브랜드 및 인기,0,0,1,1
좋은 디자인,디자인 및 크기,1,0,0,1
좋은 목소리,사운드 및 음향,1,0,0,1
좋은 사용 경험,사용자 경험 및 만족도,1,0,0,1
좋은 향,기타,1,0,0,1
주방에서 사용,사용 환경 및 용도,1,0,0,1
주방과 식탁,디자인 및 스타일,0,0,1,1
주방과 다이닝룸 구조 문제,제품 특징 및 사용성,0,0,1,1
주방 가전,기타,0,0,1,1
스탠바이미고 미개봉품,제품 및 가격 정보,0,0,1,1
주문 날짜,기타,0,0,1,1
주목 받음,기타,1,0,0,1
좋은 활용성,사용 경험 및 후기,1,0,0,1
좋은 컨셉,제품 만족도 및 인기,1,0,0,1
좋은 사운드,사용자 경험,1,0,0,1
좋은 추억,기타,1,0,0,1
좋은 음질,제품 및 기능 만족,1,0,0,1
좋은 음악,기타,1,0,0,1
좋은 영화,콘텐츠 및 감상,1,0,0,1
좋은 소식,기타,1,0,0,1
좋은 소리,기타,1,0,0,1
좋은 세정력,기타,1,0,0,1
좋은 사운드 스펙,기타,1,0,0,1
조립 난이도,기타,0,0,1,1
조립 가능,제품 설치 및 조립,1,0,0,1
조기 마감 가능성,이벤트 및 프로모션,0,0,1,1
제품 상세 스펙,기타,0,0,1,1
제품 재입고,기타,0,0,1,1
제품 잘 사용 중,구매 및 소비,1,0,0,1
제품 작동 안됨,사용 빈도 및 문제,0,1,0,1
제품 외관 만족,제품 상태 및 사용,1,0,0,1
제품 완판,기타,1,0,0,1
제품 손상,기타,0,1,0,1
제품 선택 어려움,가전 및 가구 선택 고민,0,0,1,1
제품 상태 양호,가격 및 상태,1,0,0,1
제품 사용 횟수,사용 빈도 및 문제,0,0,1,1
제품 제공 후 사용 후기,사용 후기 및 경험,0,0,1,1
제품 사용 빈도 낮음,기타,0,1,0,1
제품 사용 만족,제품의 장점 및 추천,1,0,0,1
제품 사용 경험,기타,0,0,1,1
제품 사양,제품 디자인 및 이동성,0,0,1,1
제품 보호 포장,내구성 및 안전성,0,0,1,1
제품 배치 위치,사용자 경험,0,0,1,1
제품 및 혜택 정보 제공,제품 정보 및 혜택,0,0,1,1
제품 미개봉,제품 상태 및 사용,0,0,1,1
제품 정보 검색,기타,0,0,1,1
제품 제작 건의,기타 이슈 및 요구,0,0,1,1
제휴카드 혜택,마케팅 및 프로모션,1,0,0,1
제품 판매 정보,기타,0,0,1,1
제한된 앱 설치,제품 기능 및 성능,0,1,0,1
제품에 대한 긍정적 인식,기타,1,0,0,1
제품명: 스탠바이미go 챔피언에디션,기타,0,0,1,1
제품명: 스탠바이미 GO,기타,0,0,1,1
제품명: 스탠바이미 27ART10CKPL,기타,0,0,1,1
제품명 혼동,기타,0,0,1,1
제품명 독창성,제품 특성 및 디자인,0,0,1,1
제품력 비교,제품 비교 및 구매 고려,0,0,1,1
제품 크기 큼,제품 크기 및 구조,0,0,1,1
제품 조사 및 구매 경험 공유,제품 구매 및 경제성,0,0,1,1
제품 크기 정보,기타,0,0,1,1
제품 컨셉,제품 특성 및 기능,0,0,1,1
제품 체험,특별한 경험 및 기능,0,0,1,1
제품 차이점 혼란,기타,0,1,0,1
제품 차이점 궁금,제품 비교 및 선택,0,0,1,1
제품 증정 가능,추가 서비스 및 경품,0,0,1,1
제품 중복 불가,기타 이슈 및 요구,0,0,1,1
제품 종류 다양,기타,0,0,1,1
주방에서 시청,사용 환경 및 목적,1,0,0,1
주방에서 유용,기타,1,0,0,1
제품 모델,가격 및 구매 정보,0,0,1,1
주방에서 음악 재생,제품 특징 및 활용,1,0,0,1
직거래 설정,거래 및 판매 관련,0,0,1,1
직거래 불가,거래 및 판매,0,0,1,1
직거래 및 배달 가능,거래 및 구매 방법,0,0,1,1
직거래 권장,제품 구매 및 거래,0,0,1,1
직거래 가능 지역,지역 및 거래 조건,0,0,1,1
지하 이동,기타,0,0,1,1
지켜보는 것이 좋음,기타,0,0,1,1
지연 거의 없음,기타,1,0,0,1
지역: 의정부/서울 서대문,지역 및 거래 조건,0,0,1,1
지역 제한,기타,0,0,1,1
지역 설정,가격 및 거래,0,0,1,1
지역 내 직접 배송,거래 및 배송 관련,0,0,1,1
지속적인 성능 개선,제품 특성 및 기능,0,0,1,1
지상파TV 방송 제공 가능성,제품 및 기능,0,0,1,1
지상파 방송 미지원,기능 및 연결성,0,1,0,1
지상파 방송 감소,기타,0,0,1,1
지문자국 심함,제품 불만 및 문제,0,1,0,1
지문 및 기름때 발생,제품 기능 및 사용성,0,1,0,1
지문 문제,사용자 불만 및 문제점,0,1,0,1
직거래 요청,거래 및 배송,0,0,1,1
직거래 추천,기타,0,0,1,1
직거래 하남,제품 상태 및 거래,0,0,1,1
진구의 변화,기타,0,0,1,1
집꾸미기 필수템,특정 상황 및 용도,1,0,0,1
집 분위기 변화,기타,1,0,0,1
집 및 야외 사용,제품 및 모델 비교,0,0,1,1
질병 예방,기타,1,0,0,1
진짜 스탠바이미,사용 후기 및 신뢰,0,0,1,1
진입장벽 높음,기타,0,1,0,1
진열된 제품 구경,마케팅 및 이벤트,0,0,1,1
진심어린 격려,기타,1,0,0,1
진구의 꿈,영화 관련,0,0,1,1
직거래 희망 지역,지역 및 거래 조건,0,0,1,1
진구와 할머니의 추억,문화 및 이벤트,0,0,1,1
직접결제(네이버페이),거래 및 판매 관련,0,0,1,1
직접 수령 시 할인,제품 구매 및 거래,1,0,0,1
직접 배달,기타,0,0,1,1
직접 구입,기타,0,0,1,1
직접 구매,기타,0,0,1,1
직접 경험 권장,제품 출시 및 홍보,1,0,0,1
직거래/택배거래 가능,기타,0,0,1,1
즐거움 증가,제품 사용 경험 및 평가,1,0,0,1
즐거움,사용 및 기능,1,0,0,1
즐거운 캠핑 경험,기타,1,0,0,1
준신품,가격 및 상태,0,0,1,1
중고가 상승,기타,0,0,1,1
중고 판매,제품 구매 및 가격,0,0,1,1
중고 제품 판매,구매 및 가격 고민,0,0,1,1
중고 리셀 시세,구매 및 경제성,0,0,1,1
중고 리셀,기타,0,0,1,1
중고 구매 고민,구매 및 가격 고민,0,0,1,1
중고 구매 고려,거래 및 구매 관련,0,0,1,1
중고 거래 활발,구매 및 가격 고민,0,0,1,1
주차 편리,기타,1,0,0,1
중고거래 사이트에서 높은 가격,구매 및 사용 경험,0,0,1,1
주인공의 독백,기타,0,0,1,1
주의 필요,기타,0,0,1,1
주안7동 거래 희망,가격 및 거래,0,0,1,1
주변의 관심,브랜드 및 홍보,0,0,1,1
주변 기기 연결,제품 활용 및 기능,1,0,0,1
주변 구매자 많음,추천 및 후기,0,0,1,1
주방에서 활용 가능,사용 환경 및 활용도,1,0,0,1
주방에서 활용,사용 장소 및 활용,0,0,1,1
중고거래,가격 및 거래,0,0,1,1
중고거래 시장 프리미엄,제품 출시 및 리뷰,0,0,1,1
즐거운 체험,사용 후기 및 신뢰,1,0,0,1
중국발 포터블 모니터,기타,0,0,1,1
즐거운 집에서의 시간,제품 사용 경험,1,0,0,1
즐거운 여가 생활,사용 경험 및 인기,1,0,0,1
즐거운 사용 경험,고객 경험 및 리뷰,1,0,0,1
즉시 응답 가능,기타,0,0,1,1
중소바이미 설명,브랜드 및 광고,0,0,1,1
중소기업 스마트 모니터와 스탠드 세트,기타,0,0,1,1
중소기업 TV 구매,기타,0,0,1,1
중국에서 제품 구매 어려움,기타,0,1,0,1
중국 시장의 성장 가능성,시장 및 출시 전략,0,0,1,1
중고기기 매입,제품 및 브랜드 인식,0,0,1,1
중국 시장 진출,시장 및 출시 전략,0,0,1,1
중국 내 판매 여부,기타,0,0,1,1
중고시장에서 인기,시장 반응 및 인기,0,0,1,1
중고나라 앱 이용,가격 및 거래,0,0,1,1
중고나라 앱 소개,기타,0,0,1,1
중고나라 앱 사용 권장,판매 및 거래,0,0,1,1
중고나라 앱 다운로드,판매 및 마케팅,0,0,1,1
중고나라 앱 노출,거래 및 판매,0,0,1,1
제품 문의 증가,기타,0,0,1,1
제품 명칭 혼란,기타,0,0,1,1
캠핑장 분위기,사용 환경 및 활용도,1,0,0,1
전국 무료 설치,기타,0,0,1,1
저렴한 렌탈 구매,구매 및 가격,1,0,0,1
저렴한 렌탈,가격 및 렌탈,1,0,0,1
저렴한 대안,제품 특징 및 활용,0,0,1,1
저렴한 가격으로 흉내내는 사람들,가격 및 경제성,0,0,1,1
저렴한 가격대,가격 및 할인,1,0,0,1
저렴한 가격 탐색,구매 고려 및 비교,0,0,1,1
저렴하고 간편한 해외택배,배송 및 수령,0,0,1,1
저렴이 버전 효율성 논란,가격 및 구매,0,0,1,1
저녁에만 오픈,기타,0,0,1,1
저녁 데이트 코스 적합,디자인 및 스타일,1,0,0,1
저녁 데이트 장소,기타,1,0,0,1
저녁 데이트 술집 추천,사회 및 커뮤니티,1,0,0,1
재판매 일정 미정,기타,0,0,1,1
재택근무에 적합,기타,1,0,0,1
재택근무 활용,기타,1,0,0,1
재택근무 가능,제품 특성 및 기능,1,0,0,1
재택근무,기타,0,0,1,1
재방문의사,구매 및 경제성,1,0,0,1
재미있는 체험,기타,1,0,0,1
저렴한 숙박,기타,1,0,0,1
저렴한 스탠바이미,기타,0,0,1,1
저렴한 월 비용,제품 및 모델 비교,1,0,0,1
적당한 가격,기타,0,0,1,1
적절한 스탠드 길이,기타,1,0,0,1
적절한 높이,스탠드 및 설치 관련,1,0,0,1
적절한 가격,사용자 경험,1,0,0,1
적응 가능,소비자 반응,1,0,0,1
적립금 증가,기타,1,0,0,1
적립금,기타,0,0,1,1
적당한 테이블 찾기,기타,0,0,1,1
적당한 양,기타,1,0,0,1
적극 추천,제품의 장점 및 추천,1,0,0,1
저렴한 이용,구매 및 가격,1,0,0,1
저자 정보,기타,0,0,1,1
저신용자 지원,기타,0,0,1,1
저신용도 렌탈 가능,기타,0,0,1,1
저소음,제품 특성 및 기능,1,0,0,1
저반사,제품 기능 및 성능,0,0,1,1
저렴한 해외택배,가성비 및 가격,0,0,1,1
저렴한 테이블 선택,기타,0,0,1,1
저렴한 제품과의 비교,제품 비교 및 추천,0,0,1,1
재미있는 제품 평가,기타,1,0,0,1
재미있는 제품,기타,1,0,0,1
재미있는 시청 경험,가족 및 공동 사용,1,0,0,1
잘못 배송됨,배송 및 포장,0,1,0,1
장단점 정리,사용 경험 및 평가,0,0,1,1
장단점,기타,0,0,1,1
장기간 사용,사용 환경 및 장소,1,0,0,1
장 건강,건강 및 생활,1,0,0,1
잡초 속 고사리 찾기,기타,0,0,1,1
잠금 장치,기타,0,0,1,1
잠금 버튼 필요,제품 기능 및 연결성,0,0,1,1
잠금 버튼 사용,기타,0,0,1,1
잘못 구매,사용자 경험,0,1,0,1
장단점 존재,제품 기능 및 성능,0,0,1,1
잘 작동하는 바퀴,기타,1,0,0,1
잘 산 제품,제품 사용 경험 및 평가,1,0,0,1
잘 사용 중,제품 사용 경험 및 평가,1,0,0,1
잘 구성된 커리큘럼,참여 및 체험,1,0,0,1
잔잔한 소리,고객 경험 및 만족도,1,0,0,1
작품 소개,영화 및 문화,0,0,1,1
작품 감흥 부족,콘텐츠 및 감상,0,1,0,1
작은 화면 아쉬움,제품 특징 및 사용,0,1,0,1
장단점 정보 필요,사용자 경험 및 평가,0,0,1,1
"장르 모험, 드라마",기타,0,0,1,1
재미있는 색감,기타,1,0,0,1
장점 부족,기타,0,1,0,1
재미있는 기본 게임,다양한 기능 및 설정,1,0,0,1
재미와 감동,기타,1,0,0,1
재능에 대한 신의 메시지,문화 및 엔터테인먼트,1,0,0,1
재고 확인 방법,구매 및 가격,0,0,1,1
재고 확보 어려움,제품 개선 및 아쉬움,0,1,0,1
재고 부족 우려,기타,0,1,0,1
장점이 많은 제품,사용 경험 및 평가,1,0,0,1
장점 소개,고객 경험 및 리뷰,0,0,1,1
장점 많은 제품,제품의 장점 및 추천,1,0,0,1
장바구니 문제,문제 및 개선점,0,1,0,1
장애아동 및 비장애형제자매 학습,기타,0,0,1,1
장식용으로 적합,디자인 및 공간 활용,1,0,0,1
장시간 사용 가능,기능 및 성능,1,0,0,1
장소와 크기의 제약,스탠바이미 제품,0,1,0,1
장소에 따른 콘텐츠 시청 가능,사용 용도 및 환경,1,0,0,1
장비 배치 고민,제품 설치 및 이동 문제,0,1,0,1
장비 만족,제품 만족도 및 홍보,1,0,0,1
장박지 사용 예정,사용 환경 및 장소,0,0,1,1
전 모델 구입,제품 모델 및 출시,0,0,1,1
전국 배송,기타,0,0,1,1
제품 디자인 예쁨,디자인 및 인테리어,1,0,0,1
전기료 절약,에너지 및 환경,1,0,0,1
제작 가능성,기타,0,0,1,1
제작 2024년 1월,제품 상태 및 거래 조건,0,0,1,1
제빙기 가격,구매 및 가격 혜택,0,0,1,1
제로페이 사용 가능,기타,1,0,0,1
제로베젤,기능 및 성능,1,0,0,1
제로 커넥트 박스,기타,0,0,1,1
정품 전용가방 포함,제품 상태 및 포장,0,0,1,1
정품 스탠바이미 판매,거래 및 가격,0,0,1,1
정품 새상품,제품 구매 및 거래,0,0,1,1
정품 구매,기타,1,0,0,1
정직하지 않은 블로그 포스팅,기타,0,1,0,1
정전식 터치 디스플레이,제품 성능 및 기능,0,0,1,1
정전기 방지,기타,1,0,0,1
정용진 효과,시장 및 소비자 반응,0,0,1,1
정용진 부회장의 인스타그램 게시,브랜드 및 홍보,0,0,1,1
정식 판매 시작,제품 모델 및 출시,0,0,1,1
정상작동 확인,제품 상태 및 제조 정보,1,0,0,1
정상가 119만원,기타,0,0,1,1
정상가,기타,0,0,1,1
제작 어려움,사용자 경험,0,1,0,1
제작 의뢰,부가 정보 및 기타,0,0,1,1
제작비 지원,기타,0,0,1,1
제품 구매 만족,사용자 경험 및 만족도,1,0,0,1
제품 디자인,제품 특성 및 디자인,1,0,0,1
제품 대여 체험,렌탈 및 구매 옵션,0,0,1,1
제품 다양성,제품 비교 및 구매 고려,1,0,0,1
제품 내구성,제품 내구성 및 품질,1,0,0,1
제품 기능 탐색,제품 기능 및 성능,0,0,1,1
제품 구입 고려,제품 비교 및 구매 고려,0,0,1,1
제품 구매 욕구,구매 및 소비자 반응,1,0,0,1
제품 구매 시기,기타,0,0,1,1
제품 구매 경험 공유,기타,0,0,1,1
제작연도 1986,기타,0,0,1,1
제품 구매 결정,제품 구매 및 결정,1,0,0,1
제품 구매,기타,0,0,1,1
제조일자 2024년 4월,제품 구성 및 특성,0,0,1,1
제조일자 2023년 9월,제조 및 생산,0,0,1,1
제조일,기타 제품 및 서비스,0,0,1,1
제조년월 2024년 6월,기타,0,0,1,1
제조년월 2024.06,기타,0,0,1,1
제조 연도,기타,0,0,1,1
정상 작동 확인,구매 및 거래,0,0,1,1
정상 구매가격,구매 및 가격 혜택,0,0,1,1
정보 부족,기타,0,1,0,1
전용 스탠드,기타,1,0,0,1
전원공급 방식,제품 특징 및 활용,0,1,0,1
전원 코드 꽂는 부분 괜찮음,기타,0,0,1,1
전원 연결 없이 사용 가능,기타,0,0,1,1
전원 본체,기타,0,0,1,1
전원 및 볼륨 조절 버튼,제품 기능 및 디자인,0,0,1,1
전용테이블 사용 불편,사용자 경험,0,1,0,1
전용가방 케이스 필요,제품 및 액세서리,0,0,1,1
전용가방,제품 및 액세서리,0,0,1,1
전용 리모컨 제공,사용 및 설치,0,0,1,1
전원선 정리 불편,기타,0,1,0,1
전시회 현장 수령,배송 및 수령,0,0,1,1
전시상품,가격 및 구매 정보,0,0,1,1
전시 특가,제품 구매 및 경제성,1,0,0,1
전시 상품 판매,기타,0,0,1,1
전시 감상 좋음,콘텐츠 및 감상,1,0,0,1
전선 필요,제품 설치 및 조립,0,1,0,1
전선 연장 필요,기타,0,0,1,1
전동휠로 이동 편리,편의 및 이동성,1,0,0,1
전원선 정리,기타,1,0,0,1
전자기기 구매 욕구,기타,1,0,0,1
정기배송,제품 구매 및 기대,0,0,1,1
접이식 포터블 모니터,제품 기능 및 성능,0,0,1,1
정기구독 혜택,정기구독 및 서비스,1,0,0,1
정기구독 할인,마케팅 및 이벤트,1,0,0,1
정기구독 추천템,구매 및 사용 경험,0,0,1,1
정기구독 신청,제품 구매 및 기대,0,0,1,1
정규방송 수신 여부 불확실,기능 및 연결성,0,1,0,1
정규 시리즈 우승 엠블럼,제품 출시 및 홍보,0,0,1,1
정격전압 정보,부가 정보 및 기타,0,0,1,1
정가 29만원,가격 및 거래,0,0,1,1
접이식 가능,사용 편의성 및 기능,0,0,1,1
전자기기 미러링 및 페어링,제품 기능 및 사용성,1,0,0,1
절약 방법 제공,제품 구매 및 경제성,0,0,1,1
절약 방법,기타,0,0,1,1
전화 연결 기능,기타,0,0,1,1
전현무 사용 공개,사용자 경험 및 만족도,0,0,1,1
전체관람가,기타,0,0,1,1
전작 대비 개선,혁신 및 업그레이드,0,0,1,1
전자랜드 비산점 가전 구매,기타,0,0,1,1
전자기기 이해 부족,기타,0,0,1,1
집안 어디서나 사용 가능,제품 특성 및 기능,1,0,0,1
집안 어디서든 활용 가능,이동성과 휴대성,1,0,0,1
집안 이동 용이,이동 및 설치 용이성,1,0,0,1
캠핑 자주 다님,캠핑 및 이동성,0,0,1,1
캠핑 및 여행 즐거움,이동 및 캠핑 활용,1,0,0,1
캠핑 및 여가시간에 적합,사용 용도 및 적합성,1,0,0,1
캠핑 및 여가시간 활용,기타,0,0,1,1
캠핑 및 어디든 휴대성,기타,1,0,0,1
캠핑 및 야외용 TV,이동 및 캠핑 활용,0,0,1,1
캠핑 및 야외 활동에 이상적,기타,1,0,0,1
캠핑 및 야외 활동에 유용,제품 활용 및 기능,1,0,0,1
캠핑 및 야외 활동에 용이,이동 및 휴대성,1,0,0,1
캠핑 및 야외 활동 적합,캠핑 및 야외 활동,1,0,0,1
캠핑 및 야외 사용 추천,캠핑 및 야외활동,1,0,0,1
캠핑 및 야외 사용,제품 특성 및 용도,0,0,1,1
캠핑 및 실내 사용 편리,캠핑 및 야외 활동,0,0,1,1
캠핑 및 드라이브 사용,기타,1,0,0,1
캠핑 및 공원에서 사용,사용 환경 및 활용,1,0,0,1
캠핑 및 게임 용도 가능,캠핑 및 외부 활동,1,0,0,1
캠핑 미사용,기타,0,0,1,1
캠핑 모니터,캠핑 및 이동성,0,0,1,1
캠핑 느낌,기타,1,0,0,1
캠핑 관심,캠핑 및 야외 활동,1,0,0,1
캠핑 및 여행에서 사용 가능,기타,1,0,0,1
캠핑 및 여행에서 유용,캠핑 및 야외활동,1,0,0,1
캠핑 및 외부 활용,캠핑 및 외부 활용,1,0,0,1
캠핑 사용 어려움,기타,0,0,1,1
캠핑 외 활용성 부족,캠핑 및 외부 활용,0,1,0,1
캠핑 영상 시청,캠핑 및 야외 활동,1,0,0,1
캠핑 시 태블릿 사용,이동 및 휴대성,0,0,1,1
캠핑 시 유용,제품 내구성 및 휴대성,0,0,1,1
캠핑 시 사용,캠핑 및 휴대성,0,0,1,1
캠핑 선호,캠핑 및 야외 활동,0,0,1,1
캠핑 생활,캠핑 및 야외 활동,1,0,0,1
캠핑 사용 좋음,제품 특징 및 사용,1,0,0,1
캠핑 사용 만족,사용자 경험 및 평가,1,0,0,1
캠핑 및 외부 활용 가능,이동 및 캠핑 활용,0,0,1,1
캠핑 사용 고려,사용 용도 및 환경,0,0,1,1
캠핑 분위기 향상,제품 특징 및 사용,1,0,0,1
캠핑 밤 감성,기타,0,0,1,1
캠핑 및 차박에서의 편리함,사용 환경 및 활용도,0,0,1,1
캠핑 및 집콕에 적합,기타,0,0,1,1
캠핑 및 집콕에 유용,캠핑 및 이동성,0,0,1,1
캠핑 및 이동식 TV,캠핑 및 휴대성,0,0,1,1
캠핑 및 이동 중 사용 가능,기타,1,0,0,1
캠핑 TV로 활용,사용 환경 및 활용,1,0,0,1
캠핑 TV 판매,거래 및 가격,0,0,1,1
캠핑 TV 사용,캠핑 및 야외 활동,1,0,0,1
침실 인테리어,디자인 및 공간 활용,0,0,1,1
카라반,사용 용도 및 환경,0,0,1,1
카드사 할인,기타,1,0,0,1
카드 할인 정보,제품 구매 및 가격,0,0,1,1
카드 할부 결제 가능,결제 및 구매 관련,0,0,1,1
카드 청구할인,가격 및 거래,1,0,0,1
카드 청구 할인,프로모션 및 혜택,1,0,0,1
침실에서 시청 어려움,사용 용도 및 환경,0,1,0,1
침실에서 시청,사용 환경 및 용도,0,0,1,1
침실 사용,사용 환경 및 용도,0,0,1,1
카라반에서 사용 불편,사용 환경 및 용도,0,1,0,1
침실 기능 중점,기타,0,0,1,1
침실 가림 커튼,디자인 및 스타일,0,1,0,1
침대에서 편리함,사용 경험,1,0,0,1
침대에서 유튜브 시청,사용 사례 및 추천,0,0,1,1
침대에서 영상 시청,제품 특징 및 사용성,0,0,1,1
침대에서 사용,기타,1,0,0,1
침대방에 작은 스마트TV와 빔프로젝트 있음,기타,0,0,1,1
침대방 및 안방에서 사용,활용 및 용도,1,0,0,1
카라반에서 사용 문제,사용 환경 및 설치,0,1,0,1
카멜마운트 슬림형 이동식 테이블,기타,0,0,1,1
캠퍼들이 많이 사용,사용 환경 및 목적,0,0,1,1
캐리백 사용 희망,기타,0,0,1,1
캠퍼들 사이 인기,캠핑 및 휴대성,1,0,0,1
캠퍼 타겟 제품,기타,0,0,1,1
캠퍼 및 여행자 맞춤,캠핑 및 휴대성,1,0,0,1
캠퍼 대상 인기,사회적 이슈 및 트렌드,1,0,0,1
캘리포니아 여름 선셋 테마,기타,1,0,0,1
캐주얼한 생활에 적합,기타,1,0,0,1
캐스트 프로그램 연결 가능,기타 기능 및 특징,0,0,1,1
캐스트 연결로 유사 기능,제품 성능 및 기능,0,0,1,1
캐나다 출국 준비,기타,0,0,1,1
카밍베이지 색상,디자인 및 인테리어,1,0,0,1
카페 테이블 설치,기타,0,0,1,1
카페 상품 게시글 노출,마케팅 및 커뮤니티 반응,0,0,1,1
카키색 케이스 만족,디자인 및 개인화,1,0,0,1
카키색 케이스,부가 정보 및 기타,1,0,0,1
카카오프렌즈 춘식이,이벤트 및 프로모션,0,0,1,1
카카오프렌즈 블루투스 마이크 스피커 증정,이벤트 및 프로모션,1,0,0,1
카카오프렌즈 골프 굿즈 제공,구매 및 가격 혜택,0,0,1,1
카카오웹툰 앱 탑재,제품 특성 및 기능,1,0,0,1
캠핑 인기 용품,캠핑 및 야외활동,1,0,0,1
캠핑 장비 구매,기타,0,0,1,1
집안의 편안함 제공,제품 특징 및 사용성,0,0,1,1
캠핑 정보,아웃도어 및 캠핑,0,0,1,1
캠핑용 최적화 디자인,캠핑 및 휴대성,1,0,0,1
캠핑용 아쉬움,사용 환경 및 용도,0,1,0,1
캠핑용 스탠바이미 출시,아웃도어 및 캠핑,0,0,1,1
캠핑용 스탠드,제품 활용 및 기능,1,0,0,1
캠핑용 스마트TV,기타,0,0,1,1
캠핑용 스마트 TV,사용 및 기능,0,0,1,1
캠핑용 모니터 화질과 성능,기술 및 성능,0,0,1,1
캠핑용 룸앤티비,캠핑 및 휴대성,1,0,0,1
캠핑용 디자인,디자인 및 혁신,1,0,0,1
캠핑용 기대,캠핑 및 야외 활동,0,0,1,1
캠핑용 구매 증가,사용 용도 및 적합성,0,0,1,1
캠핑용 TV로 사용 가능,사용 용도 및 환경,1,0,0,1
캠핑용 TV로 사용,기타,0,0,1,1
캠핑용 TV 모니터 인기,캠핑 및 휴대성,1,0,0,1
캠핑용 TV 관심,캠핑 및 야외활동,0,0,1,1
캠핑에서의 사용,캠핑 및 야외 활동,0,0,1,1
캠핑에서 휴대성과 편의성,캠핑 및 야외 활동,1,0,0,1
캠핑에서 활용도 좋음,제품 특징 및 사용,1,0,0,1
캠핑에서 활용,캠핑 및 야외 활동,0,0,1,1
캠핑용 티비,캠핑 및 야외 활동,0,0,1,1
캠핑용 티비 구매,캠핑 및 휴대성,0,0,1,1
캠핑용 포터블 모니터 장점,제품 활용 및 기능,0,0,1,1
캠핑용품 가방,이동성과 휴대성,0,0,1,1
캠핑장 방문,기타,1,0,0,1
캠핑장 미사용,사용 환경 및 용도,0,0,1,1
캠핑의 질 향상,제품 특징 및 사용,1,0,0,1
캠핑을 위한 구매,캠핑 및 야외활동,0,0,1,1
캠핑용품으로 최고,추천 및 활용,1,0,0,1
캠핑용품 추천,캠핑 및 야외 활동,1,0,0,1
캠핑용품 체험단,참여 및 체험,0,0,1,1
캠핑용품 수집,기타,0,0,1,1
캠핑용으로 적합,사용 환경 및 용도,1,0,0,1
캠핑용 활용,사용 환경 및 활용,1,0,0,1
캠핑용으로 용도 변경,이동 및 캠핑 활용,0,0,1,1
캠핑용으로 사용 가능,사용 용도 및 환경,0,0,1,1
캠핑용으로 사용,기타,0,0,1,1
캠핑용으로 부적합,캠핑 및 휴대성,0,1,0,1
캠핑용으로 고민,사용 환경 및 설치,0,0,1,1
캠핑용도,기타,0,0,1,1
캠핑용 휴대용 TV,캠핑 및 야외활동,0,0,1,1
캠핑용 휴대성,캠핑 및 외부 활용,0,0,1,1
캠핑에서 필요,사용 환경 및 용도,1,0,0,1
캠핑에서 필수,기타,1,0,0,1
캠핑에서 큰 화면으로 영상 시청 희망,사용 환경 및 용도,0,0,1,1
캠핑 필수,캠핑 및 휴대성,1,0,0,1
캠핑에 어울림,캠핑 및 휴대성,1,0,0,1
캠핑생활 향상,캠핑 및 야외 활동,1,0,0,1
캠핑모니터,캠핑 및 휴대성,0,0,1,1
캠핑감성에 최적화,기타,1,0,0,1
캠핑/카라반 여행에 적합,캠핑 및 휴대성,1,0,0,1
"캠핑, 피크닉, 여행에서 사용",기타,1,0,0,1
캠핑 활용,기타,1,0,0,1
캠핑 필수 템,기타,1,0,0,1
캠핑 티비로 선택,기타,1,0,0,1
캠핑에 적합한 LG 제품,캠핑 및 휴대성,0,0,1,1
캠핑 티비로 LG 스탠바이미go 선택,기타,1,0,0,1
캠핑 취소,사용자 경험 및 평가,0,0,1,1
캠핑 추천,캠핑 및 야외 활용,0,0,1,1
캠핑 중 활용 가능,캠핑 및 야외 활용,1,0,0,1
캠핑 중 편안한 시청,캠핑 및 야외 활동,1,0,0,1
캠핑 중 사용 가능,기타,1,0,0,1
캠핑 중 모니터 사용 편의성,제품 활용 및 기능,1,0,0,1
캠핑 준비 번거로움,캠핑 및 외부 활동,0,1,0,1
캠핑에 이상적,캠핑 및 야외 활동,1,0,0,1
캠핑에 적합한 TV,캠핑 및 휴대성,1,0,0,1
캠핑에서 즐거움 제공,캠핑 및 이동성,1,0,0,1
캠핑에서 스탠바이미 사용 고려,캠핑 및 휴대성,0,0,1,1
캠핑에서 즐거움,캠핑 및 야외 활용,1,0,0,1
캠핑에서 인기,캠핑 및 야외 활동,1,0,0,1
캠핑에서 영상 시청,제품 특성 및 용도,1,0,0,1
캠핑에서 스피커 대체,이동성과 설치,1,0,0,1
캠핑에서 스탠바이미고 사용 기대,기타,1,0,0,1
캠핑에서 스탠바이미고 사용,캠핑 및 야외 활동,0,0,1,1
캠핑에서 스탠바이미고 관찰,사용 환경 및 용도,0,0,1,1
캠핑에서 스탠바이미 사용 추천,캠핑 및 이동성,1,0,0,1
캠핑에서 스탠바이미 사용,캠핑 및 야외 활동,0,0,1,1
캠핑에 적합한 가방 수납형,제품 적합성 및 사용 장소,0,0,1,1
캠핑에서 사용 편리,기타,1,0,0,1
캠핑에서 사용 예정,기타,0,0,1,1
캠핑에서 사용 고려,사용 환경 및 용도,0,0,1,1
캠핑에서 디지털 보드게임,캠핑 및 야외 활용,0,0,1,1
캠핑에서 다양한 활용,사용 환경 및 활용,1,0,0,1
캠핑에서 게임,사용 환경 및 활용,0,0,1,1
캠핑에 좋은 스탠바이미 고,제품 특징 및 사용,1,0,0,1
캠핑에 적합한 파워뱅크 필요,사용 환경 및 용도,0,0,1,1
침대나 소파에서 사용,사용 사례 및 추천,0,0,1,1
침대 옆에서 사용,기타,1,0,0,1
침대 옆 사용 적합,제품 기능 및 사용성,1,0,0,1
친절한 직원,서비스 및 지원,1,0,0,1
청주 직거래 원함,거래 및 지역 관련,0,0,1,1
청주 직거래,구매 및 거래 위치,0,0,1,1
청소년물로 개봉,영화 및 문화,0,0,1,1
청구할인 혜택,가격 및 결제 옵션,1,0,0,1
첫 환전 고객 환율우대 100%,기타,1,0,0,1
첫 가입 시 저렴한 이용료,구매 및 경제성,0,0,1,1
첫 3DCG 작품,기타,0,0,1,1
천장 시청,편의성과 활용,0,0,1,1
척추 건강,기타,0,0,1,1
챔피언에디션,가격 및 구매,0,0,1,1
챔피언 에디션,제품 출시 및 홍보,0,0,1,1
챌린지 촬영,기타,0,0,1,1
챌린지 참여 방법,이벤트 및 혜택,0,0,1,1
챌린지 영상 이벤트,프로모션 및 이벤트,0,0,1,1
찾아가고 싶은 섬 이벤트,제품 추천 및 체험,0,0,1,1
찾는 재미,기타,1,0,0,1
창원직거래,제품 상태 및 거래,0,0,1,1
참여 조건,제품 판매 및 혜택,0,0,1,1
참여 인증,이벤트 및 홍보,0,0,1,1
체계적인 학습,학습 및 콘텐츠,1,0,0,1
체스 게임,기타,0,0,1,1
체스판 대체 가능,기타,1,0,0,1
초기 구매 및 사용,기타,0,0,1,1
초도물량 완판,기타,1,0,0,1
초도 물량,기타,0,0,1,1
초기비용 없음,이벤트 및 프로모션,0,0,1,1
초기 설정 방법,사용 만족 및 편의성,0,0,1,1
초기 설정 도움,기타,0,0,1,1
초기 사용 어려움,기타,0,1,0,1
초기 비용 없음,구매 및 가격 혜택,1,0,0,1
초기 구매 비용 없음,기타,1,0,0,1
초 특가 판매,거래 및 구매 관련,0,0,1,1
체어 몬테라CVT2,제품 특징 및 구성,0,0,1,1
체험형 팝업스토어,제품 출시 및 이벤트,0,0,1,1
체험단 이벤트 당첨자 발표,사용자 경험,0,0,1,1
체험단 이벤트 관심,이벤트 및 프로모션,1,0,0,1
체험단 이벤트,추천 및 계획,0,0,1,1
체험단 선정,마케팅 및 커뮤니티 반응,1,0,0,1
체험단 모집 광고,기타,0,0,1,1
체험 기회,구매 및 이벤트,0,0,1,1
체험 공간,참여 및 체험,0,0,1,1
참여 고민,기타 이슈 및 요구,0,0,1,1
참신한 시도,브랜드 및 인기,1,0,0,1
찬사,시장 반응 및 인기,1,0,0,1
집콕 생활 지루함 해소,기타,1,0,0,1
차량 내 사용 가능,사용 환경 및 장소,1,0,0,1
차기 모델 고려,사용자 경험 및 평가,0,0,1,1
차 안에서 영화 보기,제품 기능 및 사용성,1,0,0,1
차 안에서 게임,제품 기능 및 사용성,1,0,0,1
찔러보기 사절,제품 상태 및 거래,0,0,1,1
짭텐바이미 사용 이유,부가 기능 및 기타,0,0,1,1
짧은 실사용시간,제품 상태 및 제조 정보,1,0,0,1
짧은 사용 시간,제품 상태 및 사용,0,0,1,1
집중도,사용 경험 및 인기,1,0,0,1
차량 적재 가능,이동 및 설치 용이성,1,0,0,1
집에서의 시간 활용,사용 및 설치,1,0,0,1
집에서 활용도 낮음,사용 편의성 및 기능,0,1,0,1
집에서 영화 및 게임,사용 편의성,1,0,0,1
집에서 스피커 출력량,스피커 및 음질,0,0,1,1
집에서 사용 가능성,사용자 경험 및 평가,0,0,1,1
집에서 TV/스마트폰 시청 증가,사용 및 설치,0,0,1,1
집에서 TV 시청에 적합,기타,0,0,1,1
집에서 TV 불필요,사용 환경 및 용도,1,0,0,1
차량 이동 편리,기타,1,0,0,1
차량 적재 어려움,기타,0,1,0,1
착화제,사용 용도 및 환경,0,0,1,1
차박에 적합,기타,1,0,0,1
착탈식 플레이트 편리,사용 및 설치 편리성,1,0,0,1
착불 판매,사용자 경험,0,0,1,1
착불 선불 4000원,추가 비용 및 조건,0,0,1,1
차박캠핑,사용 용도 및 환경,0,0,1,1
차박캠 사용,사용 환경 및 용도,0,0,1,1
차박여행,사용 용도 및 환경,0,0,1,1
차박에서 사용 계획,기타,0,0,1,1
차박에서 사용,기타,0,0,1,1
차박 최적화,캠핑 및 휴대성,1,0,0,1
차량 필요,기타,0,1,0,1
차박 자주 감,사용 환경 및 용도,0,0,1,1
차박 사용,캠핑 및 야외 활동,0,0,1,1
차박 및 캠핑에서 사용,캠핑 및 야외 활동,0,0,1,1
차박 및 캠핑에 적합,캠핑 및 휴대성,0,0,1,1
차박 및 캠핑 사용,기타,1,0,0,1
차박 관련 체험,기타,0,0,1,1
차로 배송 가능,거래 및 가격,0,0,1,1
차량 휴대성,활용 및 용도,1,0,0,1
초캠몰 신고,기타,0,1,0,1
초특가,시장 및 경제,1,0,0,1
최강핫딜 스탠바이미 액정필름,제품 특성 및 기능,1,0,0,1
출시일,기타,0,0,1,1
출판 정보,기타,0,0,1,1
출장지 사용,부가 정보 및 기타,0,0,1,1
출장 시 반가움,고객 경험 및 만족도,0,0,1,1
"출연 배우: 윌 휘튼, 리버 피닉스, 코리 펠드만, 제리 오코넬",영화 및 문화,0,0,1,1
"출연 배우 윌 휘튼, 리버 피닉스, 코리 펠드먼, 제리 오코넬",기타,0,0,1,1
출연 배우,기타,0,0,1,1
출시일 차이,기타,0,0,1,1
출시일 정보 부족,기타,0,1,0,1
출시 전 인기,제품 출시 및 홍보,1,0,0,1
충분한 사운드 출력,제품 내구성 및 성능,1,0,0,1
출시 기다림,제품 구매 및 기대,0,0,1,1
축구 시청,사용자 경험 및 기능,0,0,1,1
추첨 경품,이벤트 및 홍보,0,0,1,1
추천하는 장소,기타,1,0,0,1
추천으로 구입,기타,1,0,0,1
추천받은 제품,제품 비교 및 평가,1,0,0,1
추천 팁,사용 사례 및 추천,0,0,1,1
추천 이벤트,기타,0,0,1,1
충격에 강함,내구성 및 안전성,1,0,0,1
충전 단자 잘 빠짐,기타,0,1,0,1
추천 많음,추천 및 후기,1,0,0,1
취향 저격 제품,제품 특징 및 활용,1,0,0,1
친절한 안내,서비스 및 지원,0,0,1,1
친절한 설치 서비스,서비스 및 지원,1,0,0,1
친절하고 빠른 상담,사용자 경험,1,0,0,1
친구와 전시회 관람,기타,0,0,1,1
친구들의 칭찬,제품 비교 및 평가,1,0,0,1
친구들 칭찬,기타,1,0,0,1
치유 가능성,기타,0,0,1,1
취향에 맞는 사용,기타,1,0,0,1
취침 전 전원 끄기,사용 및 기능,0,0,1,1
충전 방법 문의,사용 편의성 및 기능,0,0,1,1
충전식 장점,기타,1,0,0,1
충전식 배터리,기타,0,0,1,1
충전시간,기술 및 성능,0,0,1,1
충전기 별도 구매 필요,기타,0,1,0,1
충전/교체 가능한 배터리 필요,설치 및 사용 불편,0,1,0,1
충전 필요,제품 특징 및 사용,0,0,1,1
충전 중 작동 문제,사용 빈도 및 문제,0,1,0,1
충전 상태 표시,편의성과 활용,0,0,1,1
추천 여부 문의,사용 경험 및 후기,0,0,1,1
추억의 명작,영화 및 문화,1,0,0,1
최고의 제품 선택 방법,구매 및 사용 경험,0,0,1,1
최상급 제품,기타,0,0,1,1
최신모델,제품 및 기술 사양,1,0,0,1
최신 제품,기타,0,0,1,1
최신 영상기술,제품 활용 및 기능,1,0,0,1
최신 기술 적용,제품 기능 및 기술,0,0,1,1
최신 기술 경험,기타,1,0,0,1
최신 기술,제품 성능,1,0,0,1
최상의 화질,기술 및 성능,1,0,0,1
최상의 시청 경험,화질 및 시청 경험,1,0,0,1
최대 42인치 지원,제품 크기 및 이동성,0,0,1,1
최신형 제품,기타,0,0,1,1
최대 42인치 디스플레이 지원,제품 디자인 및 크기,0,0,1,1
최대 10만 포인트,참여 및 이벤트,0,0,1,1
최근 출시된 27인치 모니터,기타,0,0,1,1
최근 제조,제조 및 생산,1,0,0,1
최근 제작 상품,기타,0,0,1,1
최근 사용 시작,기타,0,0,1,1
최근 구매 제품,기타,0,0,1,1
최고의 핫템,제품 평가 및 후기,1,0,0,1
최신형 전자제품 매입,시장 및 경제,0,0,1,1
최애 아이템,제품 만족도 및 홍보,1,0,0,1
추가 셋팅 번거로움,기타,0,1,0,1
최적의 인테리어 효과,디자인 및 공간 활용,1,0,0,1
추가 비용 없는 신규 콘텐츠 업데이트,교육 및 학습,1,0,0,1
추가 라이브 진행 예정,제품 출시 및 이벤트,0,0,1,1
추가 구매 필요성,가격 및 구매 옵션,0,1,0,1
추가 가전 추천 요청,기타,0,0,1,1
추가 가입 필요 여부,기타,0,0,1,1
최첨단 엔터테인먼트,제품 성능 및 기능,0,0,1,1
최첨단 기능,제품 특징 및 기능,1,0,0,1
최적화된 화면으로 모바일 컨텐츠 및 SNS 즐김,엔터테인먼트 및 콘텐츠,1,0,0,1
최적의 스탠바이 솔루션,기타,1,0,0,1
최장 3시간 사용 가능,기타,0,0,1,1
최저가 핫딜 공유,제품 정보 및 혜택,1,0,0,1
최저가 판매,가격 및 거래,1,0,0,1
최저가 정보 제공,기타,1,0,0,1
최저가 정보 공유,제품 정보 및 혜택,1,0,0,1
최저가 정보,가격 및 구매,0,0,1,1
최저가 문의,가격 및 거래,0,0,1,1
최저가 검색,구매 및 이벤트,0,0,1,1
최저가 86만원,구매 및 가격 고민,0,0,1,1
스탠바이미고 및 팬히터 구매 가능,기타 제품 및 서비스,0,0,1,1
스탠바이미 고 TV,기타,0,0,1,1
스탠바이미고 미개봉 신품 구입,제품 상태 및 거래,0,0,1,1
구매 시기 24년 2월,제품 출시 및 트렌드,0,0,1,1
구매 이력 관리,구매 및 배송,1,0,0,1
구매 의향,구매 과정,0,0,1,1
구매 우려,개인 사정 및 기타,0,0,1,1
구매 용이성 증가,마케팅 및 판매,1,0,0,1
구매 욕구 증가,기타,1,0,0,1
구매 욕구 유발,사용자 경험 및 만족도,0,0,1,1
구매 예정자 도움,구매 및 할인,1,0,0,1
구매 여력 부족,가격 및 경제성,0,1,0,1
구매 시기: 2023년 9월,구매 및 거래,0,0,1,1
구매 성공 만족,가격 및 구매,1,0,0,1
구매 결정 만족,제품 구매 및 만족도,1,0,0,1
구매 불만,구매 및 판매 관련 이슈,0,1,0,1
구매 방법 문의,구매 및 판매 정보,0,0,1,1
구매 및 조립 불편,사용 및 설치,0,1,0,1
구매 문의 정보 제공,거래 및 구매 관련,0,0,1,1
구매 기회,구매 및 판매 정보,0,0,1,1
구매 관심,구매 및 거래,0,0,1,1
구매 과정 문제,문제 및 개선점,0,1,0,1
구매 고려 중,기타,0,0,1,1
구매 계획,제품 구매 및 가격,0,0,1,1
구매 이벤트 당첨,이벤트 및 혜택,1,0,0,1
구매 전 장단점 고려,제품 비교 및 선택,0,0,1,1
구매 지역,거래 및 지역 관련,0,0,1,1
구매 필요성 의문,구매 및 선택 고민,0,0,1,1
구입 기회,구매 및 배송,0,0,1,1
구입 고민자에게 좋은 찬스,제품 선택 및 구매,1,0,0,1
구입 고민자에게 도움,구매 및 가격 고민,0,0,1,1
구식 TV 교체 필요,기타,0,0,1,1
"구성품 본체, 케이블, 리모콘",구성품 및 부속품,0,0,1,1
구성품 다양,사용자 편의성,0,0,1,1
구성 만족,기타,1,0,0,1
구버전 스탠드 봉 전원선 홀 없음,기타,0,1,0,1
구미 생산라인,기타,0,0,1,1
구매처 인증 가능,제품 상태 및 거래,0,0,1,1
구매의사 있는 사람에게만 판매,구매 및 가격 관련,0,0,1,1
구매 희망,기타,0,0,1,1
구매 후회,구매 및 판매 관련 이슈,0,1,0,1
구매 후기 관심,구매 및 소비자 경험,0,0,1,1
구매 후 아쉬움,사용 경험 및 후기,0,1,0,1
구매 후 변화,기타,1,0,0,1
구매 후 만족,제품 출시 및 리뷰,1,0,0,1
구매 후 2개월 사용,사용 후기 및 신뢰,0,0,1,1
구매 확정 이벤트,가격 및 구매,0,0,1,1
구매 경험 공유,사용 경험 및 후기,0,0,1,1
구매 결정 도움 필요,구매 및 거래,0,0,1,1
깔끔하고 심플한 디자인,제품 기능 및 디자인,1,0,0,1
광고 ONAIR,광고 및 홍보,0,0,1,1
광고 효과,기타,1,0,0,1
광고 퀄리티,기타,1,0,0,1
광고 잘 제작됨,기타,1,0,0,1
광고 인식,광고 및 인식,0,0,1,1
광고 이벤트,이벤트 및 프로모션,1,0,0,1
광고 음악,부가 기능 및 기타,0,0,1,1
광고 신뢰성 증가,제품 인지도 및 광고,1,0,0,1
광고 관심,광고 및 홍보,0,0,1,1
광고 V-LOG 컨셉 좋음,기타,1,0,0,1
관심 증가,사용자 경험 및 만족도,1,0,0,1
구매 결심,기타,1,0,0,1
관심 요청,제품 출시 및 트렌드,0,0,1,1
관심 변화,기타,0,0,1,1
관리 상태 양호,제품 상태 및 문제,1,0,0,1
관련 제품 구매,기타,0,0,1,1
관객 기대감 상승,광고 및 홍보,1,0,0,1
과목 추가 비용 제외,추가 비용 및 조건,0,1,0,1
과도한 월세지출,기타,0,1,0,1
과거 회상,기타,0,0,1,1
공홈 할인가 26.5만원,가격 및 거래,0,0,1,1
광고 효과 의문,기타,0,0,1,1
광고모델 변우석,기타,0,0,1,1
광명애견운동장 근접,기타,0,0,1,1
광시야각 패널,기능 및 성능,1,0,0,1
구매 가이드 제공,기타,0,0,1,1
구매 가격 만족,기타,1,0,0,1
구매 가격,제품 정보 및 혜택,0,0,1,1
구로3동 거래 희망,거래 및 배송 관련,0,0,1,1
구독/렌탈,가격 및 구매 옵션,0,0,1,1
구독 혜택,기타,0,0,1,1
구독 특가전,프로모션 및 혜택,0,0,1,1
구독 가능,기타,1,0,0,1
구글티비 사용 문제 해결,기타,1,0,0,1
구글 크롬캐스트 빌트인,제품 및 기술 사양,1,0,0,1
구글 인증 OS 탑재,기타,1,0,0,1
구글 안드로이드,기술 및 기능,0,0,1,1
교훈적인 이야기,기타,0,0,1,1
교환 필요,제품 결함 및 서비스,0,0,1,1
교환 가능,추천 및 계획,0,0,1,1
교촌치킨 허니콤보 웨지감자세트,기타,0,0,1,1
교육용 구입 가능 여부,교육 및 특별 용도,0,0,1,1
괜찮은 음량,사용자 경험,1,0,0,1
괜찮은 디스플레이,제품 기능 및 성능,1,0,0,1
구입 만족,사용자 경험,1,0,0,1
구입 부담,구매 및 소비자 반응,0,1,0,1
구입 성공,제품 출시 및 리뷰,1,0,0,1
기숙사에서 스피커 이점 없음,기타,0,1,0,1
기존 TV 사용,사용 용도 및 환경,0,0,1,1
기울어짐 위험,기타,0,1,0,1
기억을 반쯤 지워주는 느낌,기타,0,0,1,1
기어봉 장착 고객 대상,기타,0,0,1,1
기스 방지,기타,1,0,0,1
기스 및 사용감 있음,사용 경험 및 평가,0,1,0,1
기스 및 고장 없음,제품 상태 및 관리,1,0,0,1
기스 및 결로 우려,기타,0,1,0,1
기스 걱정,제품 불만 및 문제,0,1,0,1
기분 좋음,기타,1,0,0,1
구입 시기 2022.8,제품 상태 및 거래 조건,0,0,1,1
기분 좋은 출발,기타,1,0,0,1
기부,기타,1,0,0,1
기본적인 캠핑 장비 보유,사용자 경험,0,0,1,1
기본앱 탑재,제품 및 기능 만족,0,0,1,1
기대하던 배송,배송 및 지역,1,0,0,1
기대되는 실내 조명,기타,1,0,0,1
기대감 증가,기타,1,0,0,1
기대감,소비자 반응,1,0,0,1
기대 이상의 히트,영화 및 문화,1,0,0,1
기존 TV 처분 고민,사용 및 설치 환경,0,0,1,1
기존 TV보다 작은 크기,제품 기능 및 사양,0,0,1,1
기존 TV와 다른 용도,기타,1,0,0,1
기존 모델 할인,가격 및 구매,1,0,0,1
김포공항하이마트,마케팅 및 판매,0,0,1,1
긴 배터리 수명,제품 특징 및 사용,0,0,1,1
긴 대기 시간,배송 및 설치,0,1,0,1
기획의도 입증,기타,1,0,0,1
기호성 좋음,기타,1,0,0,1
기프팅 아이템,마케팅 및 프로모션,1,0,0,1
기타 학원 시연,기타,0,0,1,1
기타 외부보호필름 미출시,기술 및 성능,0,0,1,1
기초 입문자에게 하프스터디 추천,추천 및 계획,0,0,1,1
기차길 옆에서 스탠바이미 연상,영화 및 문화,0,0,1,1
기존 제품과 큰 차이 없음,기타,0,0,1,1
기존 제품 사용,기타,0,0,1,1
기존 제품 보유,기타,0,0,1,1
기존 스탠바이미와 비교,제품 비교 및 선택,0,0,1,1
기존 스탠바이미 스탠형,제품 비교,0,0,1,1
기존 스탠드 형태,제품 디자인 및 구조,0,0,1,1
기존 셋탑과 인터넷 연결 가능 여부,기타,0,0,1,1
기존 사용 경험,기타,0,0,1,1
기존 모델과 큰 차이 없음,기타,0,0,1,1
기다림의 어려움,기타,0,1,0,1
기다리기 힘들어 스탠바이미1세대 구매,시장 반응 및 인기,0,0,1,1
기능성 베개 사용,기타,0,0,1,1
근사한 분위기,기타,1,0,0,1
그랜드체로키 출고 고객 증정,기타,0,0,1,1
그래픽 만족,기능 및 연결성,1,0,0,1
규칙 설정,사용자 경험,0,0,1,1
귀찮은 조립 문제,개인 사정 및 기타,0,1,0,1
귀여운 고양이모래,기타,1,0,0,1
궁극적인 이동성,기타,0,0,1,1
군용 등급 내구성,제품 내구성 및 휴대성,1,0,0,1
국내 여행 준비물,사용 환경 및 용도,0,0,1,1
국내 TV 시장에서 큰 관심,브랜드 및 시장 반응,1,0,0,1
구하기 힘든 제품,제품 특징 및 활용,0,0,1,1
구하기 어려움,기타,0,1,0,1
구조 단단함,제품 크기 및 구조,1,0,0,1
구입처 쿠팡,기타,0,0,1,1
구입시기 3-4개월,제품 구매 및 경제성,0,0,1,1
구입가격 105만,기타,0,0,1,1
구입 지연,기타,0,1,0,1
구입 의사,스탠바이미 제품,1,0,0,1
구입 어려움,제품 구매 및 가격,0,1,0,1
구입 시기 3-4개월,기타,0,0,1,1
근거리 거래 협의 가능,거래 및 구매 관련,0,0,1,1
근사한 사운드,사운드 및 영상 품질,1,0,0,1
기능성 베개,기타,0,0,1,1
글로벌 시장 진출 목표,시장 및 출시 전략,0,0,1,1
기능 탐색,제품 특징 및 활용,0,0,1,1
기능 업그레이드,스탠바이미 제품,0,0,1,1
기능 문제 없음,제품 특징 및 사용,1,0,0,1
기능 문의,제품 기능 및 성능,0,0,1,1
기능 다양성,기능 및 사용,0,0,1,1
기능,제품 기능 및 성능,0,0,1,1
기념상품,기타,0,0,1,1
기내 수하물로 휴대 가능,기타,1,0,0,1
긍정적인 후기를 들음,추천 및 후기,1,0,0,1
긍정적인 후기,긍정적 평가,1,0,0,1
급하게 스탠드 필요,기타,0,0,1,1
급하게 구입,구매 및 경제성,0,0,1,1
급하게 구매,기타,0,0,1,1
급처분,제품 상태 및 판매,0,0,1,1
급작스러운 구매,렌탈 및 구매 옵션,0,0,1,1
금액내림,기타,0,0,1,1
금액 궁금,가격 및 거래 조건,0,0,1,1
금액 관심,구매 및 거래,0,0,1,1
글로벌 진출,제품 혁신 및 신제품,1,0,0,1
공항 이슈,기타,0,0,1,1
공청과 비교,기타,0,0,1,1
공짜 제공에 대한 의구심,기타,0,0,1,1
겉멋 우려,기타,0,1,0,1
게임 재미,제품 사용 경험,1,0,0,1
게임 용도,사용 용도 및 적합성,1,0,0,1
게임 시 포트리스와 유사,기타 제품 및 서비스,0,0,1,1
게임 및 엔터테인먼트 최적화,활용 및 적합성,1,0,0,1
게임 및 다양한 콘텐츠,기타,1,0,0,1
게임 모드,다양한 기능 및 설정,0,0,1,1
게이밍 환경,화질 및 디스플레이,0,0,1,1
게이밍 변신,기타,0,0,1,1
게릴라 행사,기타,0,0,1,1
검증된 인기가전,기타,1,0,0,1
경복궁 데이트,기타,0,0,1,1
검은색 티비,제품 구성 및 특성,0,0,1,1
검색을 통한 정보 확인,사용자 경험,0,0,1,1
검색으로 정보 확인 가능,기타,0,0,1,1
검색어 문제,기타,0,1,0,1
건조 기능,기타,1,0,0,1
건전지 동봉,기타,1,0,0,1
건장한 남성에게 문제 없음,기타,0,0,1,1
건대 핫플레이스,건강 및 생활,1,0,0,1
건강한 음식,기타,1,0,0,1
게임 플레이,기타,1,0,0,1
게임에 좋음,기타,1,0,0,1
게임용 모니터로 추천,기타,1,0,0,1
게임용 모델 활용,기능 및 성능,0,0,1,1
"경기, 서울권 배송",기타,0,0,1,1
경기 북부권 직거래 가능,판매 및 거래,0,0,1,1
결혼식 장면의 숨겨진 인물들,기타,0,0,1,1
결혼선물로 받음,구매 및 이벤트,0,0,1,1
결혼 후 구매,기타,0,0,1,1
결혼 준비 시 TV 선택 고민,TV 구매 및 사용 고민,0,0,1,1
결혼 준비,기타,0,0,1,1
결혼 선물 선택 고민,구매 및 선택 고민,0,0,1,1
결제방법,거래 및 구매 방법,0,0,1,1
결제 인증 오류,기타,0,1,0,1
결제 옵션,기타,0,0,1,1
결제 방법,가격 및 결제,0,0,1,1
결재 반려,거래 및 구매 관련,0,1,0,1
견고한 연결 부분,제품 내구성 및 품질,1,0,0,1
견고한 브리프케이스 형태,제품 내구성 및 휴대성,1,0,0,1
격리 중 사용,건강 및 생활,0,0,1,1
겨울철 실내 활동,기타,0,0,1,1
겨울 장박 사용,캠핑 및 휴대성,0,0,1,1
게임용 아님,기타,0,0,1,1
걱정,기타,0,1,0,1
거치형 27인치 대형모니터,제품 및 기술 사양,0,0,1,1
거치대와 모니터 조합,제품 디자인 및 이동성,0,0,1,1
거실 TV 대신 사용 불편 가능성,제품 특징 및 사용성,0,0,1,1
거북목 및 일자목 교정,기타,1,0,0,1
거래방법: 11번가 선물하기,거래 및 구매 방법,0,0,1,1
거래방법 선택 가능,구매 및 거래,0,0,1,1
거래 희망 지역: 청룡동,거래 및 배송 관련,0,0,1,1
거래 희망 지역: 역삼1동,거래 및 판매 관련,0,0,1,1
거래 희망 지역: 쌍문제3동,기타,0,0,1,1
거래 희망 지역: 성북동,제품 구매 및 거래,0,0,1,1
거래 희망 지역: 부평4동,거래 및 가격,0,0,1,1
거래 희망 지역: 부천동,거래 및 지역 관련,0,0,1,1
"거래 희망 지역 흥도동,화전동",거래 및 판매,0,0,1,1
거래 희망 지역 호암.직동,거래 및 지역 관련,0,0,1,1
"거래 희망 지역 혜화동, 청담동",기타,0,0,1,1
거래 희망 지역 풍무동,제품 구매 및 거래,0,0,1,1
거래 희망 지역 중곡제4동,거래 및 배송 관련,0,0,1,1
"거래 희망 지역 위례동, 야탑1동, 중앙동",거래 및 지역 관련,0,0,1,1
거래 희망 지역 용현5동,지역 및 거래 조건,0,0,1,1
거래 희망 지역 연산제5동,기타,0,0,1,1
거래 희망 지역 역삼2동,거래 및 배송 관련,0,0,1,1
거래 희망 지역 송도5동,구매 및 거래 위치,0,0,1,1
거실 65인치 TV 사용,사용 환경 및 용도,0,0,1,1
거실 TV 사용 불가,사용 환경 및 용도,0,1,0,1
거치대 필요 없음,사용 편의성,1,0,0,1
거실 TV 사용 빈도 낮음,제품 특징 및 활용,0,1,0,1
거치대 사용 불편,제품 불만 및 문제,0,1,0,1
거치대 변색,사용자 불만 및 문제점,0,1,0,1
거치대 문제 해결,기타,1,0,0,1
거치대 문제,제품 기능 및 사양,0,1,0,1
거치대 구매 고려,설치 및 이동성,0,0,1,1
거의 새것,가격 및 상태,1,0,0,1
거의 사용하지 않음,제품 상태 및 판매,0,0,1,1
거실에 TV 없어 불편,기타,0,1,0,1
거실에 TV 소파 비선호,사용 및 설치 환경,0,0,1,1
거실에 TV 미설치,가전 및 가구 선택 고민,0,0,1,1
"거실, 침실, 주방으로 이동 가능",기타,1,0,0,1
거실 인테리어 완성,라이프스타일 및 경험,1,0,0,1
거실 서재화,제품 비교 및 기타,0,1,0,1
거실 사용 계획,제품 설치 및 사용 환경,0,0,1,1
거실 사용,사용 환경 및 활용도,0,0,1,1
거실 배치 고민,사용 및 설치 환경,0,0,1,1
거실 및 안방에서 TV 없음,제품 특징 및 활용,0,0,1,1
거실 및 방 이동 사용,사용 환경 및 설치,0,0,1,1
거실 깔끔함,사용자 경험 및 만족도,0,0,1,1
경복궁 근처 위치,기타,0,0,1,1
경복궁 역 근처,기타,0,0,1,1
공중파/종편 채널 시청 방법 문의,콘텐츠 및 사용성,0,0,1,1
고품질 엔터테인먼트 경험,기타,1,0,0,1
공간 장식 효과,기타,1,0,0,1
공간 연출,기타,0,0,1,1
공간 부족으로 구매 포기,공간 및 휴대성 문제,0,1,0,1
골프존 회원 참여 가능,참여 및 체험,0,0,1,1
고화질 영상 시청,제품 기능 및 성능,1,0,0,1
고화질 영상,제품 특성 및 기능,1,0,0,1
고화질 디스플레이,성능 및 기술,1,0,0,1
고해상도 화면,제품 기능 및 성능,1,0,0,1
고해상도 영상,기능 및 성능,1,0,0,1
고품질 엔터테인먼트,제품 및 기능 만족,1,0,0,1
경복궁 역 근처 위치,기타,0,0,1,1
고품질 스피커,기술 및 기능,1,0,0,1
고출력 스피커,스피커 및 음질,1,0,0,1
고정형 디스플레이 대체,사용 사례 및 추천,1,0,0,1
고정식 32인치 4K TV,기타,0,0,1,1
고정된 TV 선호,기타,0,0,1,1
고전영화 시청,기타,0,0,1,1
고장 없이 작동 여부,기타,0,0,1,1
고장 없음 기대,제품 및 기능 만족,1,0,0,1
고음질,사용자 경험,1,0,0,1
공간 제약 없음,기능 및 성능,1,0,0,1
공간 차지,제품 불만 및 문제,0,1,0,1
공간 차지 적음,디자인 및 공간 활용,1,0,0,1
공간 필요,기타,0,0,1,1
공중파 시청 방법 문의,제품 특징 및 활용,0,0,1,1
공중파 TV 시청 불가능,제품 활용 및 기능,0,1,0,1
공영주차장 이용 가능,기타,1,0,0,1
공식카페 미참여,기타,0,1,0,1
공식 판매 재개 미정,제품 개선 및 아쉬움,0,0,1,1
공부 필요,기타,0,0,1,1
공부 사용 가능 여부,기타,0,0,1,1
공간활용성,디자인 및 공간 활용,1,0,0,1
공간의 경계를 넘다,디자인 및 공간 활용,0,0,1,1
공간의 경계를 넘고 싶음,기타,0,0,1,1
공간에 자연스럽게 어울림,디자인 및 스타일,1,0,0,1
공간 효율적 활용,기타,1,0,0,1
공간 효율적,디자인 및 공간 활용,1,0,0,1
공간 효율성,디자인 및 공간 활용,1,0,0,1
공간 활용성,공간 활용 및 설치,1,0,0,1
공간 활용 좋음,기타,1,0,0,1
공간 활용,기타,0,0,1,1
공간 확보,공간 활용 및 설치,1,0,0,1
공간 협소한 상황에서 인테리어,기타,0,0,1,1
고양이의 활발한 움직임,사용 및 설치 환경,0,0,1,1
고양이 최애간식,기타,1,0,0,1
고양이 눈 반짝이게 함,기타,1,0,0,1
고가의 경품,이벤트 및 프로모션,1,0,0,1
고가 가전제품,가격 및 경제성,0,0,1,1
고가,가격 및 구매,0,1,0,1
고 이사의 불쾌한 행동,기타,0,1,0,1
계좌이체로 카드할인 가능,구매 및 배송,0,0,1,1
경험의 제한성,사용 후기 및 경험,0,0,1,1
경품 혜택,프로모션 및 이벤트,0,0,1,1
경품 행사,마케팅 및 프로모션,1,0,0,1
경품 추첨 이벤트,이벤트 및 경품,0,0,1,1
경품 증정,프로모션 및 이벤트,0,0,1,1
경품 이벤트 진행 중,마케팅 및 이벤트,0,0,1,1
경품 수령,추천 및 계획,0,0,1,1
경품 다양,기타,0,0,1,1
경품 내용,프로모션 및 이벤트,0,0,1,1
경주 인근 배송 협의,거래 및 배송 관련,0,0,1,1
경제적 타겟,가격 및 구매 옵션,0,0,1,1
경제적 렌탈,제품 구매 및 경제성,0,0,1,1
경복궁역 인근 위치,위치 및 환경,1,0,0,1
경복궁역 근처 위치,기타,0,0,1,1
경복궁역 근처,위치 및 환경,0,0,1,1
고가 브랜드 제품 부담,기타,0,1,0,1
고가의 제품,사용자 경험,0,1,0,1
고양이 기호성 좋음,기타,1,0,0,1
고객 높은 관심,시장 및 소비자 반응,1,0,0,1
고양이 간식 추천,기타,1,0,0,1
고선명 클리어 타입 필름,제품 및 액세서리,1,0,0,1
고민 후 구매 추천,제품 출시 및 리뷰,1,0,0,1
고민 중,제품 비교 및 선택 고민,0,0,1,1
고릴라캠핑 울산점 체험 가능,브랜드 및 이벤트,0,0,1,1
고디의 후원자,기타,0,0,1,1
고디의 성장,제품 출시 및 리뷰,0,0,1,1
고급진 케이스로 변경,외관 및 디자인,1,0,0,1
고급스러운 후면 마감재,제품 기능 및 성능,1,0,0,1
고급스러운 분위기의 LP바,디자인 및 스타일,1,0,0,1
고급스러운 디자인,제품 디자인 및 만족도,1,0,0,1
고급 케이스 변경,개인 사정 및 기타,1,0,0,1
고급 바,사회 및 커뮤니티,1,0,0,1
고광택,제품 기능 및 성능,1,0,0,1
고객자가 설치,서비스 및 지원,0,0,1,1
고객자 설치,기타,0,0,1,1
고객감동경영대상,사용 후기 및 경험,0,0,1,1
고객 직접 설치 가능,제품 설치 및 사용,0,0,1,1
고객 자가 설치,제품 설치 및 조립,0,0,1,1
깔끔하고 세련된 스타일,디자인 및 스타일,1,0,0,1
깔끔하고 예쁜 디자인,디자인 및 공간 활용,1,0,0,1
"거래 희망 지역 산본1동, 금정동",기타,0,0,1,1
당근 직거래,거래 및 판매,0,0,1,1
대단한 모델,제품의 장점 및 추천,1,0,0,1
대구 팝업스토어,이벤트 및 프로모션,0,0,1,1
대구 직거래 가능,거래 및 판매,0,0,1,1
대구 지역 직거래,가격 및 거래,0,0,1,1
당첨자 발표 일정,이벤트 및 프로모션,0,0,1,1
당첨 희망,기타,0,0,1,1
당첨 기쁨,이벤트 및 프로모션,1,0,0,1
당일 재고,기타,1,0,0,1
당근 활용 추천,기타,0,0,1,1
단팥 없는 단팥빵,기타,0,0,1,1
다품목 할인,기타,1,0,0,1
단차 확인 요청,기타,0,0,1,1
단자 편리함,기타,1,0,0,1
단순한 성장영화 아님,영화 관련,1,0,0,1
단순개봉 새상품,제품 상태 및 거래,0,0,1,1
단순 영상 시청 이상 기능,기타,0,0,1,1
단독 사용 가능,제품 기능 및 사용성,1,0,0,1
단단한 제품,제품 특징 및 활용,1,0,0,1
단기렌탈 서비스,기타,0,0,1,1
단기간 렌탈 가능,구매 및 가격,1,0,0,1
대단한 미러링 기능,기능 및 성능,1,0,0,1
대박 경품,참여 및 이벤트,0,0,1,1
대박 할인,프로모션 및 이벤트,1,0,0,1
대박 할인가,기타,1,0,0,1
대형 모니터,기타,0,0,1,1
대형 TV와 스탠바이미 비교,스탠바이미 제품 및 기능,0,0,1,1
대형 TV 모니터,제품 기능 및 성능,0,0,1,1
대표적인 브랜드,브랜드 및 신뢰도,1,0,0,1
대폭 할인,제품 상태 및 가격,1,0,0,1
대체품 사용,기타,0,0,1,1
대체재 부족,기타,0,1,0,1
대중적인 27인치 크기,기술 및 호환성,0,0,1,1
대중교통/대리운전 이용 권장,기타,0,0,1,1
대전 직거래 가능,지역 및 거래 조건,0,0,1,1
대전 직거래,거래 및 판매,0,0,1,1
대우 스텐레스 통세척 밥통형 가열식 가습기,기타,0,0,1,1
대역 및 특수효과 사용,사회적 이슈 및 트렌드,0,0,1,1
대여 서비스,기타,0,0,1,1
대여 기간 선택 가능,기타,0,0,1,1
대여 가능,부가 서비스 및 혜택,0,0,1,1
대안 제품 고려,구매 및 사용 경험,0,0,1,1
대세 브랜드,사용 경험 및 인기,1,0,0,1
대박인 미러링 기능,미러링 및 연결,1,0,0,1
단기 대여 이용,기타,0,0,1,1
다채로운 라이프 스타일 지원,사용자 경험 및 만족도,0,0,1,1
깔끔한 모바일OS 형태,디자인 및 외관,1,0,0,1
다양한 용도로 활용,사용 용도 및 적합성,0,0,1,1
다양한 체험,서비스 및 지원,1,0,0,1
다양한 즐길거리,기타,1,0,0,1
다양한 즐길 거리,기타,1,0,0,1
다양한 제품에 적합,기타,0,0,1,1
다양한 제품 선보임,기타,0,0,1,1
다양한 장소에서 활용,사용 용도 및 기능,1,0,0,1
다양한 장소로 이동 가능,제품 적합성 및 사용 장소,1,0,0,1
다양한 장소 활용,다양한 사용 환경,1,0,0,1
다양한 위스키 구색,기타,1,0,0,1
다양한 용도로 사용,건강 및 생활,0,0,1,1
다이슨 슈퍼소닉,기타,0,0,1,1
다양한 용도,사용자 경험 및 만족도,0,0,1,1
다양한 와인 및 주류,기타,1,0,0,1
다양한 연결 방식,제품 활용 및 기능,0,0,1,1
다양한 연결,제품 기능 및 성능,1,0,0,1
다양한 앱 연동,사용 용도 및 기능,1,0,0,1
다양한 액세서리,사용 사례 및 추천,0,0,1,1
다양한 시도,라이프스타일 및 경험,1,0,0,1
다양한 소셜 프로그램,기타,0,0,1,1
다양한 섬 방문으로 당첨 확률 증가,이벤트 및 프로모션,0,0,1,1
다양한 카테고리의 프레딧,기타,0,0,1,1
다양한 컨텐츠 접목,라이프스타일 및 경험,1,0,0,1
다양한 콘텐츠,사용자 경험,1,0,0,1
다양한 콘텐츠 감상,기타,0,0,1,1
다이렉트 음성인식,제품 기능 및 연결성,0,0,1,1
다이닝 룸에서 음악 감상,사용 경험 및 후기,0,0,1,1
다이닝 룸에서 유튜브 시청,사용 경험 및 후기,0,0,1,1
다양한 활용방법,기타,0,0,1,1
다양한 활동 가능,제품 사용 경험,1,0,0,1
다양한 환경에서 활용,기타,1,0,0,1
다양한 환경에서 사용 가능,제품 성능 및 기능,1,0,0,1
다양한 화면모드,기술 및 기능,1,0,0,1
다양한 화면 설정,다양한 기능 및 설정,0,0,1,1
다양한 화면 방향,다양한 기능 및 설정,0,0,1,1
다양한 허리베개 상품,기타,0,0,1,1
다양한 판매처,가격 및 구매,1,0,0,1
다양한 크기의 행사용 TV 제공,기타,0,0,1,1
다양한 크기 지원,제품 디자인 및 기능,0,0,1,1
다양한 크기 옵션,제품 특징 및 활용,0,0,1,1
다양한 크기,디자인 및 크기,0,0,1,1
다양한 콘텐츠 즐기기,사용 편의성,0,0,1,1
다양한 콘텐츠 이용 가능,멀티미디어 기능,1,0,0,1
다양한 콘텐츠 시청,기타,0,0,1,1
대형 태블릿 겸 티비 사용 가능,기능 및 기술,1,0,0,1
대화면,기술 및 성능,1,0,0,1
대화면 스마트TV,기타,0,0,1,1
돌비 Atmos 사운드,제품 기능 및 성능,1,0,0,1
돌비비전,제품 기능 및 기술,0,0,1,1
돌비 애트모스 탑재,기타,1,0,0,1
돌비 애트모스 입체 음향 스피커,기능 및 성능,0,0,1,1
돌비 비전과 돌비 애트모스 지원,제품 특징 및 활용,1,0,0,1
돌비 비전/애트모스,제품 기능 및 성능,1,0,0,1
돌비 비전 애트모스,기능 및 성능,0,0,1,1
돌비 비전 소리,제품 기능 및 성능,1,0,0,1
돌비 비전 및 돌비 애트모스 지원,제품 특징 및 사용,1,0,0,1
돌비 비전,사운드 및 영상 품질,1,0,0,1
독학용 추천,기타,1,0,0,1
대화면 시청,사용 환경 및 편리성,0,0,1,1
독특한 캐리백 디자인,디자인 및 외관,1,0,0,1
독특한 제품,디자인 및 외관,1,0,0,1
독특한 전자기기,디자인 및 기능,1,0,0,1
독특한 이름,기타,0,0,1,1
독특한 아름다움,디자인 및 품질,1,0,0,1
독특한 신개념 디스플레이,디자인 및 스타일,0,0,1,1
독특한 스타일,제품 특성 및 기능,1,0,0,1
독특한 모양,기타,1,0,0,1
독특한 기능,기술 및 기능,1,0,0,1
돌비비전 및 돌비애트모스 지원,제품 기능 및 성능,1,0,0,1
돌비비전 및 액트모스 미적용,기타,0,1,0,1
돌비사운드,기술 및 기능,1,0,0,1
돌비애트모스 사운드 지원,제품 및 기술 사양,1,0,0,1
뒤 부분 색상 차이,제품 기능 및 성능,0,0,1,1
둘이서 게임 재미있음,기타,1,0,0,1
두세편 시청 가능,기타,0,0,1,1
두부텐더 좋음,기타,1,0,0,1
두려움 극복,문화 및 엔터테인먼트,0,0,1,1
두 번째 TV로 스탠바이미 사용,제품 특징 및 사용성,1,0,0,1
동축케이블 연결 문제,기타,0,1,0,1
동축케이블 연결 기억,기타,0,0,1,1
동축케이블 없음,부정적 평가,0,1,0,1
동일한 카드 납부,기타,0,0,1,1
동영상 시청 선호,콘텐츠 및 감상,0,0,1,1
동영상 강의 활용,기타,1,0,0,1
동시에 시청 가능,기타,0,0,1,1
동시 시청 시 필요,제품 특징 및 사용성,1,0,0,1
동계 캠핑 필수 아이템,기타,1,0,0,1
동거,기타,0,0,1,1
돔텐트 구매,기타,1,0,0,1
돌비에트모스 스피커,제품 기능 및 성능,0,0,1,1
돌비애트모스 지원,플랫폼 및 기술 지원,0,0,1,1
독일에서 추가 필요 사항,배송 및 지역,0,0,1,1
독서 환경 개선,고객 경험 및 만족도,1,0,0,1
독립적 사용,이동 및 사용 편의성,0,0,1,1
도라에몽 3D 영화 개봉 예정,영화 및 문화,0,0,1,1
도라야끼 소개,기타,0,0,1,1
데일리한 스타일,디자인 및 스타일,1,0,0,1
데일리룩 연출,기타,1,0,0,1
데일리 사용,제품 특징 및 활용,1,0,0,1
데이트하기 좋은 분위기,기타,1,0,0,1
데이트코스로 추천,라이프스타일 및 경험,1,0,0,1
데이트코스 추천,특정 사용자 및 활용 사례,1,0,0,1
데이트 장소,기타,1,0,0,1
데이트 및 혼자 시간 보내기 좋음,건강 및 생활,1,0,0,1
데이트 및 소개팅 장소 추천,추천 및 활용,1,0,0,1
데이터 소모 많음,캠핑 및 야외 활동,0,1,0,1
데이터 부족,기타,0,1,0,1
더빙 미완료,기타,0,0,1,1
더 큰 화면으로 집중도 향상,기타,1,0,0,1
더 큰 화면에서 콘텐츠 감상,기타,1,0,0,1
더 큰 화면,제품 비교,1,0,0,1
더 일찍 구매할 걸,소비자 반응,1,0,0,1
더 많은 기능,제품 활용 및 기능,1,0,0,1
댓글수 급증,마케팅 및 커뮤니티 반응,0,0,1,1
도라에몽 3D 극장판 개봉,기타,0,0,1,1
도라에몽 극장판 스탠바이미 개봉,영화 관련,0,0,1,1
독 있음,기타,0,0,1,1
도라에몽 극장판 스탠바이미2 노래,기타,0,0,1,1
도움 받음,기타,0,0,1,1
도심 속 휴가,기타,1,0,0,1
도라에몽의 따뜻한 마음,영화 관련,1,0,0,1
도라에몽 후속작,제품 기대 및 스펙,0,0,1,1
도라에몽 탄생 50주년 기념작,제품 기대 및 스펙,0,0,1,1
도라에몽 탄생 50주년 기념대작,제품 특성 및 기능,0,0,1,1
도라에몽 스탠바이미2 영화 개봉,문화 및 엔터테인먼트,0,0,1,1
도라에몽 스탠바이미 후기,리뷰 및 체험,0,0,1,1
도라에몽 스탠바이미 피규어,영화 및 문화,0,0,1,1
도라에몽 스탠바이미 영화 정보,영화 관련,0,0,1,1
도라에몽 스탠바이미 영화 명언,기타,0,0,1,1
도라에몽 스탠바이미 시청,영화 및 문화,0,0,1,1
도라에몽 스탠바이미 극장판 소개,영화 및 문화,0,0,1,1
도라에몽 스탠바이미 감상,영화 및 콘텐츠,0,0,1,1
도라에몽 스탠바이미 3 기대,문화 및 엔터테인먼트,0,0,1,1
도라에몽 스탠바이미 2 애니메이션 개봉,제품 기대 및 스펙,0,0,1,1
도라에몽 스탠바이미 2 기대,기타,0,0,1,1
도라에몽 더빙,기타,0,0,1,1
도라에몽 극장판 중 최고의 작품,영화 및 문화,1,0,0,1
다양한 상품 판매,판매 및 마케팅,0,0,1,1
다양한 상품,마케팅 및 프로모션,0,0,1,1
다양한 사용 가능성,다양한 기능 및 설정,1,0,0,1
네고신청 거부,개인 사정 및 기타,0,0,1,1
넷플릭스 및 쿠팡플레이 사용,미러링 및 연결,0,0,1,1
넷플릭스 및 유튜브 시청,기타,0,0,1,1
넷플릭스 및 웨이브 시청 가능,기타,1,0,0,1
넷플릭스 감상 가능,제품 기능 및 성능,0,0,1,1
넷플릭스,기타,0,0,1,1
네트워크 연결로 다른 TV 시청 가능,기타,1,0,0,1
네이버페이 포인트 적립,이벤트 및 프로모션,1,0,0,1
네이버페이 직접결제,결제 및 구매 관련,0,0,1,1
네이버페이 결제 혜택,가격 및 결제,1,0,0,1
네고 사절,제품 상태 및 거래,0,0,1,1
높낮이 조절,사용 경험,1,0,0,1
네고 문의 불가,가격 및 결제,0,0,1,1
네고 가능,제품 구매 및 경제성,0,0,1,1
넘어짐 대비,기타,0,0,1,1
넘어질까 걱정,기타,0,1,0,1
넓은 활용성,제품 활용 및 기능,1,0,0,1
넓은 화면으로 쾌적한 시청 환경,기타,1,0,0,1
넓은 화면에서 모바일 콘텐츠,화면 및 콘텐츠,1,0,0,1
넓은 거실 선호,기타 기능 및 고민,0,0,1,1
넓고 편한 화면,화질 및 화면,1,0,0,1
넷플릭스 배속 불가,콘텐츠 및 감상,0,1,0,1
넷플릭스 버튼,제품 기능 및 성능,1,0,0,1
넷플릭스 사용 어려움,기타,0,1,0,1
넷플릭스 시청 가능,기타,0,0,1,1
높낮이 및 각도 조절,기타,0,0,1,1
놀라운 소식,기타,1,0,0,1
놀라운 경험 제공,참여 및 체험,1,0,0,1
논현1동 거래 희망,거래 및 판매 관련,0,0,1,1
논글레어 처리,기술 및 성능,0,0,1,1
노트북으로 축구 시청,제품 및 모델 비교,0,0,1,1
노트북/모바일 화면 공유,제품 및 기술 사양,1,0,0,1
노트북 시청의 한계,기타,0,1,0,1
노트북 및 모바일 화면 공유,기타,1,0,0,1
노출 자동화,기타,0,0,1,1
노지캠핑,사용 용도 및 환경,0,0,1,1
노은3동 거래 희망,제품 상태 및 거래,0,0,1,1
노래방 마이크 연결,기타,1,0,0,1
노래 제작,기타,0,0,1,1
노래 감상,라이프스타일 및 경험,1,0,0,1
넷플릭스와 요기요 구독 혜택,프로모션 및 혜택,1,0,0,1
넷플릭스/유튜브 지원,제품 기능 및 연결성,0,0,1,1
넷플릭스/유튜브 연동,기타,1,0,0,1
넷플릭스/와챠 시청,화면 및 콘텐츠,0,0,1,1
넉넉한 화면 크기,제품 디자인 및 크기,1,0,0,1
내적 친밀감,기타,0,0,1,1
내장배터리,제품 기능 및 사용성,0,0,1,1
날씨 풀림,기타,0,0,1,1
날씨 영향,기타,0,1,0,1
날렵한 디자인,디자인 및 구조,0,0,1,1
난리나는 화질,화질 및 화면,1,0,0,1
난로 대체,기타 기능 및 특징,1,0,0,1
낚인 느낌,제품 불만 및 실망,0,1,0,1
나홀로 캠핑에 적합,이동 및 휴대성,0,0,1,1
나혼자산다 방송 언급,기타,0,0,1,1
나혼자산다 박지현 관련,기타,0,0,1,1
꿀팁,사용 사례 및 추천,0,0,1,1
꼼꼼한 포장,배송 및 포장,1,0,0,1
깨끗한 세척,기타,1,0,0,1
깨끗한 사용,기타,1,0,0,1
깔맞춤,디자인 및 개인화,0,0,1,1
깔끔한 화질,성능 및 기술,1,0,0,1
깔끔한 퀄리티,기타,1,0,0,1
깔끔한 일체감,외관 및 디자인,1,0,0,1
깔끔한 영상 송출,기타,1,0,0,1
깔끔한 액정,제품 상태 및 포장,1,0,0,1
깔끔한 설치,제품 설치 및 사용,1,0,0,1
날씨 좋음,기타,1,0,0,1
남녀노소 사용 가능,사용자 편의성,1,0,0,1
내장 콘텐츠,제품 기능 및 성능,0,0,1,1
남녀노소 호평,사용자 경험,1,0,0,1
내장 배터리로 이동성,이동성과 휴대성,1,0,0,1
내장 배터리 포함,이동식 TV 및 포터블 스크린,0,0,1,1
내장 배터리 최대 8시간 작동,제품 특징 및 사용,1,0,0,1
내장 배터리 3시간 사용,사용자 편의성 및 이동성,0,0,1,1
내장 게임 이용 가능,기타,0,0,1,1
내부사진 촬영,기타,1,0,0,1
내돈내산,기타,0,0,1,1
내구성 테스트,제품 및 브랜드 인식,0,0,1,1
내구성 문제,내구성 및 안전성,0,1,0,1
낮은 해상도,제품 기능 및 사양,0,1,0,1
낮은 태블릿 사양,제품 기능 및 사양,0,1,0,1
낭만적이고 즐거운 시간 제공,사용자 경험 및 만족도,1,0,0,1
남편의 추천,개인 사정 및 기타,0,0,1,1
남편의 스탠바이미 선호,기타,0,0,1,1
남편의 스탠바이미 구매 제안,기타,0,0,1,1
남편의 구매 의지,사용자 경험,0,0,1,1
남자 겨울 코디 아이템,라이프스타일 및 경험,0,0,1,1
남성 손님들의 관심,기타,0,0,1,1
남성 가죽 컴포트 슈즈,구매 및 가격 혜택,0,0,1,1
높낮이 및 각도 조절 가능,사용자 편의 및 기능,1,0,0,1
높낮이 조절 가능,제품 기능 및 사양,1,0,0,1
다양한 브랜드 및 모델 비교,제품 비교 및 추천,0,0,1,1
다분할 입체구조,기능 및 성능,0,0,1,1
다양한 각도 조절,제품 기능 및 성능,1,0,0,1
다양한 가전제품,기술 및 호환성,0,0,1,1
다양한 OTT 플랫폼 지원,기타,1,0,0,1
다양한 OTT 프로그램 시청,사용 및 기능,1,0,0,1
다양한 OTT 시청,사용 용도 및 환경,0,0,1,1
다양한 OTT 서비스 이용 가능,기능 및 성능,1,0,0,1
다양한 OTT 서비스 사용,기술 및 기능,0,0,1,1
다양한 OTT 서비스,제품 특징 및 사용성,0,0,1,1
다양한 LP판,기타,1,0,0,1
다목적성,제품 및 기능 만족,1,0,0,1
높은 4K 화질,기타,1,0,0,1
다목적 멀티미디어 허브,제품 특징 및 사용성,1,0,0,1
다목적 TV 및 모니터,기타,0,0,1,1
다리에 걸리지 않음,이동 및 휴대성,1,0,0,1
다른 브랜드 제품 불편,LG전자 및 가전제품,0,1,0,1
다른 방에 설치 계획,연결 및 설치,0,0,1,1
다른 기기와 결합 가능,사용 편의성 및 기능,0,0,1,1
다량 렌탈 가능,기타,1,0,0,1
닌텐도 스위치 연결,기타,0,0,1,1
닌텐도 스위치 마리오카트 라이브 홈 서킷 패키지,부가 기능 및 기타,0,0,1,1
다양한 거래방법,가격 및 거래,0,0,1,1
다양한 게임 가능,기타,1,0,0,1
다양한 게임모드,기타,1,0,0,1
다양한 공간 활용,기타,1,0,0,1
다양한 브랜드,기타,0,0,1,1
다양한 미디어 콘텐츠,사용 용도 및 기능,0,0,1,1
다양한 모드 지원,제품 성능 및 기능,1,0,0,1
다양한 모델 호환 가능,기능 및 호환성,1,0,0,1
다양한 모델,기타,0,0,1,1
다양한 매장 컨셉 체험,기타,0,0,1,1
다양한 맛,기타,1,0,0,1
다양한 렌탈 옵션,렌탈 및 구독 서비스,0,0,1,1
다양한 디자인,제품 디자인 및 트렌드,0,0,1,1
다양한 디바이스와 원활한 연동,기능 및 성능,1,0,0,1
다양한 디바이스와 손쉬운 연결,기술 및 기능,1,0,0,1
다양한 디바이스 연결 가능,기타,1,0,0,1
다양한 기능성,기능 및 성능,1,0,0,1
다양한 기능 지원,제품 사용 및 기능,1,0,0,1
다양한 기능 사용,멀티미디어 기능,1,0,0,1
다양한 기기 지원,기타,0,0,1,1
다양한 기기 연결 지원,편의성과 활용,0,0,1,1
다양한 기기 연결,제품 스펙 및 기능,0,0,1,1
다양한 공간에서 활용 가능,기능 및 성능,1,0,0,1
닌텐도 스위치 경품,이벤트 및 혜택,0,0,1,1
닌텐도 스위치 OLED 연결,기타,0,0,1,1
닌텐도 사용자 추천,부가 기능 및 기타,1,0,0,1
뇌새김 스탠바이미고 제공,제품 특징 및 사용,0,0,1,1
뇌새김 사은품으로 스탠바이미고 수령,사은품 및 이벤트,1,0,0,1
뇌새김 만족,교육 및 학습,1,0,0,1
뇌새김 구성 시작,기타,0,0,1,1
뇌새김 계약,기타,0,0,1,1
높이 조절 찾기 어려움,제품 사용 및 설치,0,1,0,1
높이 조절 용이,기타,1,0,0,1
높이 조절,제품 성능 및 기능,0,0,1,1
높이 및 각도 조절 편리,이동성과 설치,1,0,0,1
높이 및 각도 조절 가능,제품 성능 및 기능,1,0,0,1
높은 화질,기타,1,0,0,1
높은 재방문율,기타,1,0,0,1
높은 수리비,제품 상태 및 문제,0,1,0,1
높은 성능,성능 및 기술,1,0,0,1
높은 매입가,시장 및 경제,0,0,1,1
높은 리셀가,가격 및 구매,0,0,1,1
높은 기대감,마케팅 및 이벤트,1,0,0,1
높은 기대,마케팅 및 이벤트,1,0,0,1
높은 구매율,사용자 경험 및 만족도,1,0,0,1
높은 구매 가격,구매 및 가격,0,1,0,1
뇌새김 스탠바이미 패키지 존재,교육 및 학습,0,0,1,1
뇌새김 스탠바이미고 패키지 선택,교육 및 학습,0,0,1,1
닌텐도 마리오 원더 플레이,부가 기능 및 기타,1,0,0,1
뇌새김 스탠바이미고 패키지 제공,기타,1,0,0,1
늦은 관람,기타,0,0,1,1
느낀 점 정리,사용자 경험 및 만족도,0,0,1,1
뉴트럴한 케이스,디자인 및 인테리어,0,0,1,1
눈에 부담 없는 화질,제품 내구성 및 성능,1,0,0,1
눈높이 각도 조절 가능,기타,1,0,0,1
눈과 귀를 즐겁게 함,사용 후기 및 경험,1,0,0,1
눈 건강 염려 해소,내구성 및 안전성,1,0,0,1
눈 건강 문제,제품 상태 및 관리,0,1,0,1
누워서 영화 시청,사용 환경 및 용도,0,0,1,1
누워서 영상 시청,사용 환경 및 용도,0,0,1,1
누워서 시청 및 작업 가능,콘텐츠 및 감상,1,0,0,1
누워서 시청,제품 성능 및 기능,0,0,1,1
누워서 사용 편리,사용 편의성 및 편리함,1,0,0,1
뇌새김영어 학습지,교육 및 학습,0,0,1,1
뇌새김영어 스탠바이미 제공,스탠바이미 및 스마트 모니터 관련,0,0,1,1
뇌새김영어 스탠바이미 신청,기타,0,0,1,1
뇌새김영어 가격 합리적,기타,1,0,0,1
뇌새김과 연계된 가격 정보,이벤트 및 프로모션,0,0,1,1
뇌새김 스탠바이미고 확인 중,기타,0,0,1,1
거래 희망 지역 상무1동,거래 및 배송 관련,0,0,1,1
거래 희망 지역 부평4동,거래 및 판매 관련,0,0,1,1
뒷판 색상 차이,제품 비교 및 차별성,0,0,1,1
LG 스탠바이미 Go LED FULL HD 포터블 스크린,제품 및 기술 사양,0,0,1,1
LG 스탠바이미 결정,기타,0,0,1,1
LG 스탠바이미 가능성,기타,1,0,0,1
LG 스탠바이미 가격,제품 비교 및 기타,0,0,1,1
LG 스탠바이미 TV 신제품,기타,0,0,1,1
LG 스탠바이미 TV 도착,기타,0,0,1,1
LG 스탠바이미 TV 27ART10AKPL 모델,기타,0,0,1,1
LG 스탠바이미 TV,기타,0,0,1,1
LG 스탠바이미 Go 만족,제품 환영 및 만족,1,0,0,1
LG 스탠바이미 Go 당첨 기대,마케팅 및 프로모션,1,0,0,1
LG 스탠바이미 Go 1등,기타,0,0,1,1
LG 소형 가전 구매 가능,LG전자 및 가전제품,0,0,1,1
LG 스탠바이미 Go,기타,0,0,1,1
LG 스탠바이미 GO 포함,기타,0,0,1,1
LG 스탠바이미 GO 추첨 증정,마케팅 및 프로모션,0,0,1,1
LG 스탠바이미 GO 가격,제품 모델 및 출시,0,0,1,1
LG 스탠바이미 27ART10DQPL 설치,기타,0,0,1,1
LG 스탠바이미 27ART10DQPL,기타,0,0,1,1
LG 스탠바이미 2024년 최신형,기타,0,0,1,1
LG 스탠바이미 1세대 제품 관심,브랜드 및 모델,1,0,0,1
LG 스탠바이미 + LG 그램 행사,제품 모델 및 출시,0,0,1,1
LG 스탠바이미 고 24년 2월 제조,제품 출시 및 트렌드,0,0,1,1
LG 스탠바이미 고 2주 체험,리뷰 및 체험,0,0,1,1
LG 스탠바이미 고 LG트윈스 챔피언에디션 판매,제품 특징 및 사용,0,0,1,1
LG 스탠바이미 고 북미 및 유럽 시장 출시,브랜드 및 시장 반응,0,0,1,1
LG 스탠바이미 사용 경험,기타,0,0,1,1
LG 스탠바이미 배터리 내장,기타,0,0,1,1
LG 스탠바이미 미개봉,제품 특징 및 활용,0,0,1,1
LG 스탠바이미 매력,기타,1,0,0,1
LG 스탠바이미 렌탈 서비스 소개,기타,0,0,1,1
LG 스탠바이미 렌탈 결정,제품 비교 및 구매 고려,0,0,1,1
LG 스탠바이미 다양한 활용,브랜드 및 트렌드,1,0,0,1
LG 스탠바이미 기대,제품 기대 및 스펙,0,0,1,1
LG 스탠바이미 구매 경험,기타,0,0,1,1
LG 스탠바이미 구매,제품 구매 및 가격,0,0,1,1
LG 스탠바이미 광고 ONAIR,광고 및 홍보,0,0,1,1
LG 스탠바이미 공식카페 초대,기타,0,0,1,1
LG 스탠바이미 고와 잘 어울림,기타,1,0,0,1
LG 스탠바이미 고를 위한 노래 제작,기타,0,0,1,1
LG 스탠바이미 고 할인,가격 및 혜택,0,0,1,1
LG 스탠바이미 고 필름 부착,기타,0,0,1,1
LG 스탠바이미 고 체험,기타,0,0,1,1
LG 스탠바이미 고 완판,구매 및 사용 경험,0,0,1,1
LG 스탠바이미 고 사용,제품 만족도 및 홍보,0,0,1,1
LG 스탠마이미 GO 출시,브랜드 및 모델,0,0,1,1
LG 브랜드,브랜드 및 시장 반응,0,0,1,1
LG트윈스 우승기념 한정판,한정판 및 기념품,0,0,1,1
IT쇼 전시,기타,0,0,1,1
LG MERIDIAN 스피커 사용,제품 기능 및 기술,0,0,1,1
LED표시등,제품 기능 및 디자인,0,0,1,1
LED 솔라라이트 장식,기타,0,0,1,1
LED,화질 및 성능,0,0,1,1
KT 셋톱박스 연결 가능성,기능 및 연결성,0,0,1,1
KB Pay 이벤트 참여,이벤트 및 혜택,0,0,1,1
Jammy 만족,제품 환영 및 만족,1,0,0,1
JBL 파티박스110 스피커 구매 예정,기타,0,0,1,1
JAMMY LG 제품 경험 공유,사용 경험 및 후기,0,0,1,1
IPTV M5 스마트 모니터,기타,0,0,1,1
LG 베스트샵 북울산 본점 사은품 이벤트,브랜드 및 이벤트,0,0,1,1
IPS 패널,제품 스펙 및 기술,0,0,1,1
IPS 캠핑 TV,기타,0,0,1,1
IFA 최고 제품 선정,제품 성능,1,0,0,1
HDMI 포트만 있음,제품 기능 및 사양,0,0,1,1
HDMI 포트 지원,연결 및 호환성,1,0,0,1
HDMI 연결만 가능,기능 및 사용 편의성,0,0,1,1
HDMI 연결 시도,기능 및 성능,0,0,1,1
HDMI 연결 문제 없음,사용 편의성 및 기능,1,0,0,1
HDMI 연결 기능,기타,1,0,0,1
LG TV 스탠바이미 광고,제품 인지도 및 광고,0,0,1,1
LG ThinQ 사용 가능,기능 및 호환성,1,0,0,1
LG ThinQ 앱,기타,0,0,1,1
LG ThinQ 앱 사용,기능 및 호환성,0,0,1,1
LG 배송 만족,기타,1,0,0,1
LG 모니터,기타,0,0,1,1
LG 룸앤티비 2세대,기타,0,0,1,1
LG 룸앤TV 27인치 구매,제품 특징 및 비교,0,0,1,1
LG 룸앤 TV,제품 및 기능 만족,0,0,1,1
LG 김치냉장고 추천,기타,0,0,1,1
LG 공식 홈페이지 주문,배송 및 지역,0,0,1,1
LG 공식 기사 배달,배송 및 지역,0,0,1,1
LG 가전 선호,마케팅 및 이벤트,1,0,0,1
LG 가전 구독 서비스 매력적,기타,1,0,0,1
LG web OS 특징,다양한 기능 및 설정,0,0,1,1
LG Webos 부족함,문제 및 불만,0,1,0,1
LG UHD TV 86형,기타,0,0,1,1
LG UHD TV 55형,기타,0,0,1,1
LG ThinQ 어플 사용,기타,1,0,0,1
LG ThinQ 앱스토어,기타,0,0,1,1
LG ThinQ 앱 필요,기능 및 호환성,0,0,1,1
LG ThinQ 앱 연동,제품 및 기술 사양,1,0,0,1
LG ThinQ 앱 설치,기타,0,0,1,1
LG 스탠바이미 사용 후 모델,기타,0,0,1,1
LG 스탠바이미 새상품,기타,0,0,1,1
LG 스탠바이미 선물,기타,0,0,1,1
LG 프립모임,기타,0,0,1,1
LG의 상품 기획력,기타,1,0,0,1
LG윈윈페스티벌,가격 및 구매,0,0,1,1
LG우승기념 실패,기타,0,1,0,1
LG스탠바이미 클럽 리뷰 이벤트,이벤트 및 프로모션,0,0,1,1
LG스탠바이미 GO 격려품 전달,기타,0,0,1,1
LG스탠바이미 1세대 여전히 인기,사용 경험 및 인기,0,0,1,1
LG스탠마이미 GO 출시,기타,0,0,1,1
LGU플러스TV,브랜드 및 모델 비교,0,0,1,1
LG 할인,기타,0,0,1,1
LG 프로야구 우승기념 한정판,브랜드 및 이벤트,0,0,1,1
LG 스탠바이미 스피커,기타,0,0,1,1
LG 프라이빗 스마트 스크린,기타,0,0,1,1
LG 트윈스 우승 에디션,부가 정보 및 기타,0,0,1,1
LG 터치 스크린 라인업,제품 및 기술 사양,0,0,1,1
LG 최초의 가전,기타,0,0,1,1
LG 채널 라이브 지원,기타,0,0,1,1
LG 제품의 전방 이동 가능,사용자 경험 및 만족도,0,0,1,1
LG 제품 홍보,마케팅 및 이벤트,0,0,1,1
LG 제품 일상화,기타,0,0,1,1
LG 제품 사용 기쁨,기타,1,0,0,1
LG의 성공적인 제품,제품 기대 및 스펙,1,0,0,1
LG의 혁신적인 제품,제품 혁신 및 신제품,1,0,0,1
LG인터넷TV 결합,브랜드 및 모델 비교,0,0,1,1
LG전자 2024 LED FHD 스탠바이미,스탠바이미 및 스마트 모니터 관련,0,0,1,1
LG트롬세탁기 및 건조기 효자템,LG전자 및 가전제품,1,0,0,1
LG챔피언에디션,제품 및 모델 비교,0,0,1,1
LG전자에 대한 긍정적 인식,기타,1,0,0,1
LG전자로부터 제작비 지원,광고 및 홍보,0,0,1,1
LG전자 제품 체험 가능,기타,0,0,1,1
LG전자 제품,LG전자 및 가전제품,0,0,1,1
LG전자 제작비 지원,브랜드 및 유명세,0,0,1,1
LG전자 정품 리모컨,기타,0,0,1,1
LG전자 정품,제품 출시 및 인지도,0,0,1,1
LG전자 올레드 OLED65B2ENA,구매 및 소비,0,0,1,1
LG전자 스탠바이미go,기타,0,0,1,1
LG전자 스탠바이미 Go TV,제품 및 기술 사양,0,0,1,1
LG전자 스탠바이미 Go 27LX5QKNA 포터블 스크린 소개,브랜드 및 신뢰도,0,0,1,1
LG전자 서비스 개선,제품 사용 경험 및 평가,1,0,0,1
LG전자 베스트상품,기타,1,0,0,1
LG전자 HD LED TV,제품 비교,0,0,1,1
LG전자 FHD LED 프라이빗 스마트스크린,제품 비교,0,0,1,1
LG전자 FHD LED 스탠바이미 TV,기타,0,0,1,1
LG전자 FHD LED TV 구매,기타,0,0,1,1
LG 제품 사용 경험,제품 비교 및 기타,0,0,1,1
LG 제품 사용,기타,0,0,1,1
LG 제품 구매 신기함,사용자 경험 및 만족도,0,0,1,1
LG 스탠바이미고 인테리어템,인테리어 및 디자인,0,0,1,1
LG 스탠바이미고 rev.2 판매,기타,0,0,1,1
LG 스탠바이미go 정보,스탠바이미 관련,0,0,1,1
LG 스탠바이미 획득,기타,0,0,1,1
LG 스탠바이미 호환,제품 호환 및 액세서리,0,0,1,1
LG 스탠바이미 핫딜,제품 특징 및 활용,0,0,1,1
LG 스탠바이미 할인 판매,제품 구매 및 경제성,0,0,1,1
LG 스탠바이미 할인,가격 및 구매,0,0,1,1
LG 스탠바이미 팝업,기타,0,0,1,1
LG 스탠바이미 터치 가능,기타,0,0,1,1
LG 스탠바이미 클럽 위치,기타,0,0,1,1
LG 스탠바이미 클럽 운영,스탠바이미 제품 관련,0,0,1,1
LG 스탠바이미 클럽 시즌2,기타,0,0,1,1
LG 스탠바이미 지원사업,제품 기대 및 스펙,0,0,1,1
LG 스탠바이미 제품 인지도,제품 인지도 및 광고,0,0,1,1
LG 스탠바이미 제품 언급,제품 특징 및 사용,0,0,1,1
LG 스탠바이미 제품 대여,기타,0,0,1,1
LG 스탠바이미 제품,기타,0,0,1,1
LG 스탠바이미 제공,기타,0,0,1,1
LG 스탠바이미 오리지널,기타,0,0,1,1
LG 스탠바이미고 가격,가격 및 구매,0,0,1,1
LG 스탠바이미고 증정,기타,1,0,0,1
LG 제품,브랜드 및 신뢰도,0,0,1,1
LG 스탠바이미고 증정 이벤트,이벤트 및 프로모션,0,0,1,1
LG 정품가방 판매,기타,0,0,1,1
LG 전자 행사 참여,이벤트 및 경품,0,0,1,1
LG 자체 app마켓,제품 기능 및 성능,0,1,0,1
LG 윈윈페스티벌,기타,0,0,1,1
LG 오브제 식기세척기 가격,제품 비교 및 기타,0,0,1,1
LG 오브제 냉장고 가격,제품 비교 및 기타,0,0,1,1
LG 여가챌린지,기타,0,0,1,1
LG 에어로퍼니처 가격,제품 비교 및 기타,0,0,1,1
LG 에어로타워 가격,제품 비교 및 기타,0,0,1,1
LG 스탠바이비 2등,기타,0,0,1,1
LG 스탠바이미와 삼성 제품 차별성,제품 비교 및 차별성,0,0,1,1
LG 스탠바이미와 삼성 스마트 모니터 비교,기타,0,0,1,1
LG 스탠바이미와 비교,브랜드 및 신뢰도,1,0,0,1
LG 스탠바이미고 환영,제품 환영 및 만족,1,0,0,1
LG 스탠바이미고 호환성,기타,0,0,1,1
LG 스탠바이미고 팝업스토어,기타,1,0,0,1
LG 스탠바이미고 탐남,기타,1,0,0,1
LG 스탠바이미고 케이스,기타,0,0,1,1
LG 스탠바이미고 체험단 모집 광고,제품 추천 및 체험,0,0,1,1
HDMI 및 USB 연결,기술 및 성능,0,0,1,1
HDMI 단자 지원,기능 및 사용성,1,0,0,1
HDMI 단자,제품 및 기능 만족,0,0,1,1
27% 할인,가격 및 할인,1,0,0,1
27인치 사이즈,제품 기능 및 사양,0,0,1,1
27인치 모델,기타,0,0,1,1
27인치 모니터로 게임 가능,기타,1,0,0,1
27인치 LED TV,제품 스펙 및 기술,0,0,1,1
27인치 FHD 해상도,기타,0,0,1,1
27인치 FHD 터치 디스플레이,기능 및 성능,0,0,1,1
27인치 FHD 모니터,기타,0,0,1,1
27인치,화질 및 성능,0,0,1,1
"27ART10DSPL 모델의 스펙, 디자인, 기능 분석",제품 및 기술 사양,0,0,1,1
24인치 스탠드형,제품 스펙 및 기술,0,0,1,1
31% 할인,가격 및 프로모션,1,0,0,1
24인치 사이즈,제품 특징 및 사용,0,0,1,1
24인치 모델,기타,0,0,1,1
24년형 업그레이드 여부 질문,구매 및 가격 관련,0,0,1,1
24년2월생산제품,기타,0,0,1,1
24년 3월 제조,제품 상태 및 제조 정보,0,0,1,1
24개월 무이자 할부 옵션,프로모션 및 이벤트,0,0,1,1
23년형 저렴한 가격,구매 및 가격 관련,0,0,1,1
23년과 24년 제품 차이점,기타,0,0,1,1
23년 9월 제조,부가 정보 및 기타,0,0,1,1
27인치 크기,제품 크기 및 이동성,0,0,1,1
27인치 터치스크린,기능 및 성능,0,0,1,1
27인치 터치화면,제품 특성 및 기능,1,0,0,1
27인치 화면크기,기타,0,0,1,1
300대 한정판,제품 및 모델 비교,0,0,1,1
2차로 적합,기타,1,0,0,1
2차/3차 방문,기타,1,0,0,1
2차 3차에 적합,기타,1,0,0,1
2주간 특별 체험,사용 경험 및 후기,1,0,0,1
2인용 게임 가능,기타,1,0,0,1
2인 캠핑,사용자 경험,0,0,1,1
2인 가구 적합,기타,0,0,1,1
2세대와 1세대 차이점,기타,0,0,1,1
2세대 출시 임박,제품 홍보 및 출시 기대,0,0,1,1
2세대 제품 출시,신제품 및 출시 소식,0,0,1,1
2세대 전용가방 필요,기타,0,0,1,1
2세대 스탠바이미,기타,0,0,1,1
2세대 모델 개선,기능 및 성능,1,0,0,1
2년간 무상 AS,서비스 및 지원,1,0,0,1
29% 할인 행사,이벤트 및 프로모션,0,0,1,1
27형 터치 화면,기타,0,0,1,1
27형 터치 디스플레이,스탠바이미 제품,0,0,1,1
27형 FHD 해상도,제품 특성 및 기능,0,0,1,1
23년 9월 생산,제조 및 생산,0,0,1,1
23년 10월 생산,제품 상태 및 포장,0,0,1,1
239개 리뷰,기타,0,0,1,1
1세대와 2세대 구분,기술 및 호환성,0,0,1,1
1세대 모델,제품 정보 및 출시,0,0,1,1
1세대 4K 아님,제품 기능 및 사양,0,1,0,1
1번 사용한 S급 제품,가격 및 상태,0,0,1,1
1등 상품 기대,기타,1,0,0,1
1년 이상 사용 만족,제품 구매 및 만족도,1,0,0,1
1년 사용,사용 경험,0,0,1,1
1년 반 사용 후기,기타,0,0,1,1
1962년 발표,기타,0,0,1,1
1920 X 1080 FHD 해상도,제품 기능 및 연결성,0,0,1,1
159시간 사용,기타,0,0,1,1
140cm(55인치) 스탠드형,제품 기능 및 사양,0,0,1,1
13만 원 할인,기타,1,0,0,1
1300개 강의 제공,교육 및 학습,1,0,0,1
12Kg 가능,제품 크기 및 이동성,0,0,1,1
12% 할인,가격 및 구매,0,0,1,1
117만원 가격,가격 및 경제성,0,0,1,1
10주년 이벤트,이벤트 및 홍보,0,0,1,1
100만원 초반 가격,가격 및 경제성,0,0,1,1
100% 당첨 이벤트,참여 및 체험,0,0,1,1
1세대 스탠바이미 구매,제품 비교 및 기타,0,0,1,1
1세대와 2세대 디자인 차이,디자인 및 인테리어,0,0,1,1
20W 돌비 애트모스 사운드,제품 성능,0,0,1,1
1인 1스크린 활용,사용자 경험,1,0,0,1
20W 4.2ch 돌비 애트모스 입체 음향 스피커,제품 스펙 및 기능,0,0,1,1
2024년형,화질 및 성능,0,0,1,1
2024년 출시 모델에 대한 궁금증,기타,0,0,1,1
2024년 최신 모델 정보,기타,0,0,1,1
2024년 제조,기타,0,0,1,1
2024년 신형,신제품 및 모델,0,0,1,1
2024 파리올림픽 개막,기타,0,0,1,1
2023년 제품 구매,기타,0,0,1,1
2023년 7월 제조,제조 및 생산,0,0,1,1
2023년 6월 출시,기타,0,0,1,1
2023년 5월 출시,제품 모델 및 출시,0,0,1,1
2023 한국시리즈 우승 엠블럼,이벤트 및 홍보,0,0,1,1
2021년 5월 한국 개봉,기타,0,0,1,1
1회 사용품,제품 상태 및 거래,0,0,1,1
1회 사용 후 초기화,기타,0,0,1,1
1차 물량 판매 완료,구매 및 소비자 반응,0,0,1,1
1인가구 적합,기타,0,0,1,1
1인가구 및 자취생에게 적합,사용 환경 및 장소,0,0,1,1
1인 가구 및 집꾸미기 적합,기타,1,0,0,1
30만원대 가격,가격 및 경제성,0,0,1,1
32인치 TV,기타,0,0,1,1
HDMI 노트북 및 스위치독 사용 가능,기능 및 성능,0,0,1,1
99.9% 항균력,기타,1,0,0,1
Android 미러링 지원,기능 및 성능,0,0,1,1
AirPlay 연결 가능,제품 기능 및 디자인,0,0,1,1
AS 서비스 불만,문제 및 불만,0,1,0,1
AS 남음,부가 정보 및 기타,1,0,0,1
AOD 기능 문제,제품 특징 및 활용,0,1,0,1
AI 회화 관심,교육 및 학습,1,0,0,1
AI 기반 작성 도구,제품 특성 및 기능,0,0,1,1
AI sound pro,제품 기능 및 성능,0,0,1,1
A/S 비용 무료,고객 서비스 및 지원,1,0,0,1
8주 연속 박스오피스 1위,영화 및 문화,1,0,0,1
32인치 UHD 스펙,제품 기능 및 사양,0,0,1,1
8월 구매,기타,0,0,1,1
8가지 힐링 콘텐츠 제공,엔터테인먼트 및 콘텐츠,0,0,1,1
8가지 모드,다양한 기능 및 설정,1,0,0,1
89만원 직거래,구매 및 가격 고민,0,0,1,1
7월 10일 배송,구매 및 이벤트,0,0,1,1
77인치 구매 시 스탠바이미 무료 증정,프로모션 및 혜택,0,0,1,1
70인치 이상 TV 구매,기타,0,0,1,1
6인 이상 단체석 없음,사회 및 커뮤니티,0,1,0,1
6년 만에 돌아옴,기타,0,0,1,1
Android 및 iOS 지원,제품 기능 및 사용성,0,0,1,1
Android/iOS 미러링,제품 기능 및 성능,0,0,1,1
Android/iOS 호환,플랫폼 및 호환성,1,0,0,1
Apple AirPlay 지원,기능 및 성능,0,0,1,1
HDMI USB 포트 연결,연결 및 호환성,1,0,0,1
GO 제품 출시 기대,제품 평가 및 기대,0,0,1,1
Full HD 해상도,화질 및 성능,0,0,1,1
FULL HD WebOS 탑재,제품 및 기능,0,0,1,1
FULL HD,화질 및 성능,0,0,1,1
FHD 환경 문제,화질 및 디스플레이,0,1,0,1
FHD 화질 지원,화질 및 디스플레이,0,0,1,1
FHD 화질 우려,사용 경험 및 평가,0,0,1,1
FHD 화면,제품 및 기능 만족,0,0,1,1
FHD LED 스탠바이미 Go TV,제품 기능 및 성능,0,0,1,1
FHD LED TV,기타,0,0,1,1
FHD LED,화면 및 사운드,0,0,1,1
EQ설정,제품 기능 및 디자인,0,0,1,1
DVD 평점,영화 및 미디어,0,0,1,1
DIY 스탠바이미,기타,0,0,1,1
CPU 아쉬움,성능 아쉬움,0,1,0,1
CES 최고 관심 제품,제품 출시 및 관심,1,0,0,1
Bluetooth 연결,기능 및 사용 편의성,1,0,0,1
Ben E. King의 유명한 노래,기타,0,0,1,1
6개월 이상 사용,사용 후기 및 신뢰,0,0,1,1
6개월 이상 꾸준히 사용,기타,0,0,1,1
6개월 사용 후기,기타,0,0,1,1
40만 포인트 증정,프로모션 및 혜택,0,0,1,1
3주 사용 제한 아쉬움,문제 및 개선점,0,1,0,1
3시간 활용 가능,기능 및 기술,0,0,1,1
3시간 사용 가능,제품 크기 및 이동성,0,0,1,1
3개월 실사용,기타,0,0,1,1
3개월 사용,제품 상태 및 제조 정보,0,0,1,1
3가지 화면 사용 가능,제품 비교 및 선택,0,0,1,1
3가지 모드,기타,0,0,1,1
3~4시간 사용 가능,부가 정보 및 기타,0,0,1,1
3in1 기능,제품 기능 및 성능,1,0,0,1
3DCG 애니메이션,문화 및 엔터테인먼트,0,0,1,1
3D 콘텐츠 적합성,기타,1,0,0,1
3D 콘텐츠 어울림,영화 관련,1,0,0,1
3D 이슬이 예쁨,기타,1,0,0,1
3D 설계,건강 및 안전,1,0,0,1
3D 극장판 애니메이션,영화 및 콘텐츠,1,0,0,1
36개월 할부,가격 및 결제 옵션,0,0,1,1
"32인치, 4K, 긴 배터리 아쉬움",기타,0,1,0,1
32인치 스탠드형,기타,0,0,1,1
32인치 모니터용,기타,0,0,1,1
4.0CH 스피커,기타,0,0,1,1
43인치 크기,기타,1,0,0,1
6개월 사용,제품 상태 및 사용,0,0,1,1
47% 할인,가격 및 구매,1,0,0,1
6개월 고민 후 구매,사용자 경험 및 만족도,0,0,1,1
68 cm 화면 사이즈,제품 크기 및 디자인,0,0,1,1
66만원 판매가격,가격 및 거래 조건,0,0,1,1
65인치 TV로 넷플릭스/유튜브 시청,기타,0,0,1,1
62% 할인,기타,1,0,0,1
5행시 이벤트,프로모션 및 이벤트,0,0,1,1
5월말 출시,제품 출시 및 리뷰,0,0,1,1
5세대 인공지능 알파7,제품 성능,0,0,1,1
5세대 알파7 프로세서,제품 기능 및 연결성,0,0,1,1
5년 무상 A/S,기타,1,0,0,1
50% 쿠폰 당첨,기타,1,0,0,1
4세대 인공지능 알파7 화질 엔진,기타,0,0,1,1
4세대 인공지능 알파 7 화질,기타,0,0,1,1
4세대 알파7 프로세서,제품 스펙 및 기술,0,0,1,1
4k TV 화질,화질 및 디스플레이,0,0,1,1
4K 해상도 지원,제품 특성 및 기능,1,0,0,1
4K 해상도,화면 및 사운드,1,0,0,1
4K 미지원,화질 및 디스플레이,0,1,0,1
4K UHD 올레드 TV,제품 성능 및 기능,0,0,1,1
LG트윈스 우승 한정판,기타,0,0,1,1
LG퓨리케어 오브제컬렉션 에어로퍼니처 격려품 전달,기타,0,0,1,1
"거래 희망 지역 부천동, 오정동, 상동",거래 및 배송 관련,0,0,1,1
가벼운 이동,디자인 및 공간 활용,1,0,0,1
가전 구독,구매 및 가격 혜택,1,0,0,1
가을캠핑,아웃도어 및 캠핑,0,0,1,1
가심비 만족,사용자 경험 및 만족도,1,0,0,1
가성비 좋은 큰 TV,기타,1,0,0,1
가성비 아쉬움,가격 및 경제성,0,1,0,1
가성비 모델,기타,0,0,1,1
가성비 TV 추천,라이프스타일 및 경험,1,0,0,1
가사 부담 경감,구매 및 경제성,1,0,0,1
가볍게 TV 시청 적합,기타,1,0,0,1
가방형 휴대용 스크린,캠핑 및 휴대성,0,0,1,1
가방 스타일 디자인,디자인 및 소재,0,0,1,1
가방형 휴대용 TV,디자인 및 혁신,0,0,1,1
가방처럼 사용 가능,사용 편의성 및 기능,0,0,1,1
가방일체형 무선 TV,휴대성과 보관,0,0,1,1
가방에 들어가는 티비,사용 편의성 및 편리함,0,0,1,1
가방에 들어가는 신제품,이동 및 휴대성,1,0,0,1
가방에 담기는 디자인,디자인 및 공간 활용,1,0,0,1
가방에 달린 스탠드,사용 환경 및 용도,0,0,1,1
가방 형태 디자인,제품 디자인 및 이동성,0,0,1,1
가방 장식 가능,기타,0,0,1,1
가전 구독료 시대,기타,0,0,1,1
가전 렌탈 가능,기타,0,0,1,1
가전 세일 29% 할인,가격 및 구매,0,0,1,1
가전성지,마케팅 및 판매,0,0,1,1
가족과 필드 테스트 예정,가족 및 공동 사용,0,0,1,1
가족 휴가 사용,기타,1,0,0,1
가족 피크닉에서 활용,사용 환경 및 활용,1,0,0,1
가족 캠핑에서 장점,기타,1,0,0,1
가족 캠핑,캠핑 및 야외 활동,0,0,1,1
가족 영어공부,사용자 경험 및 평가,0,0,1,1
가족 선물,특정 상황 및 용도,1,0,0,1
가족 간의 관계 개선,기타,1,0,0,1
가져다 드림,제품 설치 및 이동,1,0,0,1
가정용 및 캠핑용 구분,기타,0,0,1,1
가정에서 인기,사용 경험 및 인기,1,0,0,1
가정에서 사용 적합,다양한 사용 환경,1,0,0,1
가정에서 사용 가능,사용 환경 및 활용,0,0,1,1
가정에서 노래듣는 용도 사용,사용 환경 및 용도,0,0,1,1
가정 및 야외 사용,라이프스타일 적합성,0,0,1,1
가정 및 사무실 사용,기타,0,0,1,1
가정 내 서브 스크린,기타,0,0,1,1
가전졸업,마케팅 및 판매,0,0,1,1
가전제품 할인,기타,1,0,0,1
가방 없음,기타 이슈 및 요구,0,1,0,1
가방 내장 모니터,제품 기능 및 성능,1,0,0,1
LP 바 체험,사회 및 커뮤니티,1,0,0,1
가격 조정 최종,가격 및 거래,0,0,1,1
"가격: 600,000원",거래 및 가격,0,0,1,1
"가격: 1,250,000원",가격 및 거래,0,0,1,1
"가격: 1,170,000 원",기타,0,0,1,1
가격 혜택,가격 및 거래 조건,1,0,0,1
가격 협상,구매 및 가격 관련,0,0,1,1
가격 할인 부족,가격 및 혜택,0,1,0,1
가격 할인 가능,기타,1,0,0,1
가격 하락,구매 및 가격 관련,1,0,0,1
가격 천차만별,가격 및 구매 고려,0,0,1,1
가격 조정,가격 및 거래,0,0,1,1
가로모드/세로모드 전환 가능,제품 기능 및 디자인,0,0,1,1
가격 정보 필요,기타,0,0,1,1
가격 정보 요청,가격 및 비용,0,0,1,1
가격 적정성,기타,0,0,1,1
가격 적절,가격 및 구매,1,0,0,1
가격 인상 예정,기타,0,0,1,1
가격 이벤트,이벤트 및 혜택,0,0,1,1
가격 안내,가격 및 경제성,0,0,1,1
가격 성능,가격 및 구매,0,0,1,1
가격 상승 예상,가격 및 프로모션,0,1,0,1
"가격: 650,000원",구매 및 거래,0,0,1,1
"가격: 750,000 원",제품 및 가격 정보,0,0,1,1
"가격: 800,000 원",구매 및 가격 관련,0,0,1,1
"가격: 820,000 원",제품 구매 및 거래,0,0,1,1
가로모드,기타,0,0,1,1
가로/세로 뷰 변경 용이,기능 및 사용성,0,0,1,1
가로 이동 불가,연결 및 설치,0,1,0,1
가로 세로 회전 가능,스탠드 및 화면 조절,0,0,1,1
가끔 사용,기타,0,0,1,1
가구 감성,디자인 및 스타일,1,0,0,1
가격이 비쌈,가격 및 경제성,0,1,0,1
가격에 대한 불만,가격 및 구매,0,1,0,1
가격에 대한 관심,가격 및 구매,0,0,1,1
가격에 대한 고민,가격 및 구매,0,0,1,1
가격대에 따른 프로그램 수 차이,기타,0,0,1,1
가격대비 화질 고민,기타,0,1,0,1
가격대 높음,가격 및 할인,0,1,0,1
가격내림,가격 및 결제,0,0,1,1
"가격: 910,000 원",가격 및 상태,0,0,1,1
"가격: 890,000원",기타,0,0,1,1
"가격: 870,000원",제품 및 가격 정보,0,0,1,1
"가격: 830,000 원",구매 및 가격 관련,0,0,1,1
"가격: 820,000원",가격 및 구매,0,0,1,1
가족과 함께,기타,0,0,1,1
가족과 함께 사용,가족 및 공동 사용,0,0,1,1
가족과의 실용적 사용,사용 환경 및 용도,1,0,0,1
개봉일 정보,기타,0,0,1,1
개인적 아쉬움,사용자 경험 및 평가,0,1,0,1
개인적 사용 불필요,제품 상태 및 거래,0,0,1,1
개인용 스크린 발표,디자인 및 스타일,0,0,1,1
개인거래 예약,가격 및 거래,0,0,1,1
개인 스크린 활용 가능,기능 및 성능,1,0,0,1
개인 맞춤형,기타,0,0,1,1
개인 구매 경험,기타,0,0,1,1
개선점 제안,기타,0,0,1,1
개선된 화면 밝기,기타,1,0,0,1
개봉만한 새상품,가격 및 상태,0,0,1,1
가족과의 의미 있는 시간,기타,1,0,0,1
개봉 예정,문화 및 이벤트,0,0,1,1
개봉 새상품,제품 상태 및 가격,0,0,1,1
강추,기타,1,0,0,1
강의용 활용,사용 용도 및 적합성,0,0,1,1
강의용 사용,기타,0,0,1,1
강아지도 즐기는 제품,기타,1,0,0,1
강릉여행,기타,0,0,1,1
강렬한 에피소드,문화 및 엔터테인먼트,1,0,0,1
강력한 비난,구매 및 소비자 반응,0,1,0,1
개인적인 사정으로 사용 안함,개인 사정 및 기타,0,0,1,1
개인적인 사정으로 판매,개인 사정 및 기타,0,0,1,1
객실에 배치 희망,제품 특징 및 활용,0,0,1,1
갤럭시 버즈 증정,이벤트 및 프로모션,0,0,1,1
거래 희망 지역 부천동,거래 및 배송 관련,0,0,1,1
거래 희망 지역 동삼제1동,거래 및 판매 관련,0,0,1,1
"거래 희망 지역 도곡1동, 대화동",기타,0,0,1,1
거래 희망 지역 대덕면,거래 및 배송 관련,0,0,1,1
거래 희망 지역 금정동,기타,0,0,1,1
거래 희망 지역 구로3동,지역 및 거래 조건,0,0,1,1
거래 지역 이천,지역 및 거래 조건,0,0,1,1
거래 지역 석관동,제품 구매 및 거래,0,0,1,1
거래 지역 부천동,거래 및 배송 관련,0,0,1,1
거래 제안,기타,0,0,1,1
거래 방법: 직거래 및 택배거래,기타,0,0,1,1
거래 방법 안내,구매 및 거래,0,0,1,1
거래 방법 다양함,거래 및 배송,0,0,1,1
거래 가능 시점,거래 및 판매 관련,0,0,1,1
거대한 TV 불필요,제품 디자인 및 크기,0,0,1,1
갤럭시 핸드폰 미러링,미러링 및 연결,1,0,0,1
갤럭시 폰 호환성,제품 스펙 및 기능,1,0,0,1
갤럭시 탭,기타,0,0,1,1
갤럭시 태블릿 포함,추가 기능 및 혜택,1,0,0,1
강력한 배터리,기타,1,0,0,1
감성캠핑,캠핑 및 야외 활용,0,0,1,1
감성적인 술집,기타,1,0,0,1
간편한 휴대성,기타,1,0,0,1
간편한 해외택배,기타,0,0,1,1
간편한 터치 및 조작,이동 및 사용 편의성,1,0,0,1
간편한 이동성,제품 특성 및 기능,1,0,0,1
간편한 설치와 연결,사용 편의성,1,0,0,1
간편한 설치,구성 및 설치,1,0,0,1
간편한 미러링,기타,1,0,0,1
간단한 화면 미러링 연결,제품 성능 및 기능,1,0,0,1
간단한 형식,기타,0,0,1,1
간단한 조립,제품 디자인 및 조립,1,0,0,1
간단한 세팅,사용 및 기능,1,0,0,1
간단한 설치,사용 및 설치 편리성,1,0,0,1
간단한 설명,사용자 편의성,0,0,1,1
간단한 미러링 방법,기타,1,0,0,1
간단하고 쉬운 사용,고객 경험 및 만족도,1,0,0,1
간 건강 도움,기타,1,0,0,1
각도 조절 스탠드,제품 사용 및 설치,0,0,1,1
각도 조절 불가능,기능 및 사용성,0,1,0,1
각도 및 위치 조절 가능,사용자 편의성,1,0,0,1
가족을 통한 설치 및 전달,제품 출시 및 리뷰,0,0,1,1
간편한 휴대,제품 내구성 및 휴대성,1,0,0,1
감기,기타,0,1,0,1
감성적인 분위기,사용 환경 및 용도,1,0,0,1
감독,기타,0,0,1,1
감성적 활용,캠핑 및 외부 활용,1,0,0,1
감성적 디자인,디자인 및 소재,1,0,0,1
감성가전,제품 특징 및 활용,1,0,0,1
감성 힐링 테마,사용자 경험 및 기능,1,0,0,1
감성 캠핑용품,사용 용도 및 적합성,1,0,0,1
감성 캠핑 준비,캠핑 및 야외 활동,1,0,0,1
감성 캠핑 용품,라이프스타일 적합성,1,0,0,1
감성 충만,사용자 경험 및 리뷰,1,0,0,1
감성 숙박 경험,기타,1,0,0,1
감성 만족,콘텐츠 및 감상,1,0,0,1
감사,기타,1,0,0,1
감동적인 주제곡,광고 및 홍보,1,0,0,1
감동적인 영화,콘텐츠 및 감상,1,0,0,1
감동적인 엔딩 주제곡,마케팅 및 이벤트,1,0,0,1
감동적인 스토리,영화 및 콘텐츠,1,0,0,1
감동 후기,제품 만족도,1,0,0,1
감독 정보,기타,0,0,1,1
감독 및 출연진 정보,영화 및 미디어,0,0,1,1
감독 로브 라이너,영화 및 문화,0,0,1,1
가격 상승,가격 및 구매,0,1,0,1
가격 비쌈,제품 개선 및 아쉬움,0,1,0,1
가격 비싸다,기타,0,1,0,1
StanbyMe 두 번째 제품,기타,0,0,1,1
TV 미구매 결정,기타,0,0,1,1
TV 도착,사용 및 설치,1,0,0,1
TV 대신 스크린 사용,사용 및 설치,0,0,1,1
TV 구매 후회,부정적 평가,0,1,0,1
TV 구매 고민,TV 구매 및 사용 고민,0,0,1,1
TV 공간 차지,기타,0,1,0,1
TV 고정된 형태 사용,기타,0,0,1,1
TV 가방 제작,이동성과 휴대성,0,0,1,1
TCL 안드로이드11 4K UHD TV,제품 기능 및 사양,0,0,1,1
SUV 공간 부족,이동 및 휴대성,0,1,0,1
TV 추천,기타,1,0,0,1
SSG 카드할인,가격 및 프로모션,1,0,0,1
SQC1 SOUNDBAR,기타,0,0,1,1
SPOTV ON 응모,기타,0,0,1,1
SPOTV NOW 응모,기타,0,0,1,1
SPOTV NOW 모바일 결제 불가,기타,0,1,0,1
SPORT TV 구독 필요,제품 활용 및 기능,0,1,0,1
SNS에서 인기,기타,1,0,0,1
SNS 후기 작성,이벤트 및 프로모션,0,0,1,1
SNS 후기,프로모션 및 이벤트,0,0,1,1
TV 미사용,기타,0,0,1,1
TV 미설치 고려,제품 특징 및 활용,0,0,1,1
TV 미시청자 관심,기타,0,0,1,1
TV 및 노트북 겸용,기타,1,0,0,1
TV 처분 후 대안 고민,기타,0,0,1,1
TV 제품 등록,기타,0,0,1,1
TV 용도로 적합,제품 적합성 및 사용 장소,0,0,1,1
TV 용도,기타,0,0,1,1
TV 연결 귀찮음,기타,0,0,1,1
TV 없이 사용 가능,기타,1,0,0,1
TV 없이 모니터 사용,기타,0,0,1,1
TV 없음,제품 활용 및 기능,0,0,1,1
TV 없는 가정집 추천,제품 특성 및 기능,1,0,0,1
TV 없는 가정에서 사용,기타,0,0,1,1
TV 없는 가정에 적합,사용 환경 및 용도,1,0,0,1
TV 시청 시간 증가,시장 및 경제,1,0,0,1
TV 시청 경험 가치,기타,0,0,1,1
TV 수신료 부담,기타,0,1,0,1
TV 설치 옵션,사용 및 설치,0,0,1,1
TV 설치 고민,기타,0,0,1,1
TV 선택 고민,기타,0,0,1,1
TV 보유,기타,0,0,1,1
TV 및 인터넷 약정 만료,기타,0,0,1,1
S55 메탈 롱바디 가격 높음,기타,0,1,0,1
RC PRO 연결,부가 정보 및 기타,0,0,1,1
QR코드 스캔 가능,기술 및 기능,0,0,1,1
OTT 및 캠핑 유행,특정 상황 및 용도,0,0,1,1
OTT 구독 필요,시장 및 경제,0,0,1,1
OTT 감상,기타,0,0,1,1
OST 스탠 바이 미,콘텐츠 및 감상,0,0,1,1
OLED 기술,기타,1,0,0,1
No Hassle 문구,이벤트 및 프로모션,0,0,1,1
NFC 연결,기능 및 사용 편의성,1,0,0,1
NFC 미러링,기술 및 성능,1,0,0,1
NFC 기능으로 큰 화면,기능 및 호환성,1,0,0,1
M시리즈 삼성 모니터 사용,사용 사례 및 추천,0,0,1,1
MZ세대 시청 행태 파악,기타,0,0,1,1
MZ 세대에게 인기,기타,1,0,0,1
MZ 세대 이해,추천 및 계획,0,0,1,1
MZ 세대 맞춤형 제품,기타,0,0,1,1
MIL-STD-810H 등급 인증,보호 및 내구성,1,0,0,1
MIL-STD 인증 하드케이스,기타,1,0,0,1
MIL-STD 인증,기술 및 성능,1,0,0,1
MIL-STD 810H 내구성,제품 내구성 및 성능,1,0,0,1
METES 커뮤니티 운영,기타,0,0,1,1
L사이즈,기타,0,0,1,1
OTT 로그인 접근성,제품 특징 및 사용,1,0,0,1
OTT 서비스 사용,기타,1,0,0,1
QR코드 만족도 조사,이벤트 및 프로모션,0,0,1,1
OTT 서비스 사용 편리,화면 및 콘텐츠,1,0,0,1
QHD 제한,제품 기능 및 사용,0,1,0,1
Q&A 답변,기타,0,0,1,1
PC통신 시대,기타,0,0,1,1
OTT/유튜브 시청에 적합,제품 특징 및 활용,1,0,0,1
OTT/유튜브 시청 만족,제품 사용 경험 및 평가,1,0,0,1
OTT/유튜브 시청,기타,0,0,1,1
OTT/유튜브 쇼츠 시청,제품 기능 및 사용,0,0,1,1
OTT 플랫폼 즐기기,기타,1,0,0,1
OTT 프로그램 시청,사용자 경험 및 기능,1,0,0,1
OTT 콘텐츠 감상,기능 및 성능,1,0,0,1
OTT 지원,제품 및 기능 만족,1,0,0,1
OTT 외 기능,화면 및 콘텐츠,0,0,1,1
OTT 애플리케이션 지원,다양한 기능 및 설정,0,0,1,1
OTT 시청에 적합,사용 환경 및 용도,1,0,0,1
OTT 시청 시 화질,제품 스펙 및 기술,0,0,1,1
OTT 시청 불편,사용 환경 및 용도,0,1,0,1
OTT 시청 가능,기타,1,0,0,1
OTT 서비스 이용 용이,멀티미디어 기능,1,0,0,1
OTT 서비스 시청 편리,사용 환경 및 편리성,1,0,0,1
TV 처분 후 대체 고민,제품 비교 및 평가,0,0,1,1
TV 크기 고민,사용 환경 및 용도,0,0,1,1
가격 비교에서 스탠바이미 구매 유리,가격 및 경제성,1,0,0,1
"가격 570,000원",거래 및 가격,0,0,1,1
"가격 720,000 원",가격 및 렌탈,0,0,1,1
"가격 710,000원",구매 및 거래,0,0,1,1
"가격 710,000 원",구매 및 가격 관련,0,0,1,1
가격 70만원,거래 및 가격,0,0,1,1
"가격 700,000 원",제품 구매 및 거래,0,0,1,1
가격 68만원,가격 및 결제,0,0,1,1
"가격 660,000원",가격 및 비용,0,0,1,1
가격 60만원,가격 및 비용,0,0,1,1
"가격 580,000원",가격 및 거래,0,0,1,1
"가격 560,000원",제품 구매 및 경제성,0,0,1,1
TV 크기와 기능 중요성,기타,0,0,1,1
"가격 40,000원",구매 및 거래,0,0,1,1
가격 30만원대,가격 및 구매 정보,0,0,1,1
"가격 250,000원",구매 및 가격 고민,0,0,1,1
"가격 25,000원",가격 및 거래,0,0,1,1
"가격 190,000원",가격 및 거래,0,0,1,1
"가격 185,000원",가격 및 거래 조건,0,0,1,1
가격 120만원대,제품 구매 및 가격,0,0,1,1
가격 117만원,가격 및 경제성,0,0,1,1
"가격 1,700,000원",가격 및 거래,0,0,1,1
"가격 780,000 원",기타,0,0,1,1
"가격 840,000원",가격 및 거래,0,0,1,1
가격 84만원,가격 및 거래,0,0,1,1
"가격 860,000원",제품 구매 및 가격,0,0,1,1
가격 변동 가능,가격 및 할인,0,0,1,1
가격 변동,가격 및 거래,0,0,1,1
가격 범위,구매 및 가격 혜택,0,0,1,1
가격 명시,기타,0,0,1,1
가격 만족,가격 및 구매,1,0,0,1
가격 대비 화질 아쉬움,사용 경험 및 평가,0,1,0,1
가격 대비 화질,기타,0,1,0,1
가격 대비 스펙 고민,가격 및 결제,0,0,1,1
가격 대비 소중히 사용 필요,가격 및 구매 옵션,0,0,1,1
가격 높음,가격 및 경제성,0,1,0,1
가격 내림,가격 및 상태,0,0,1,1
가격 관심,가격 및 비용,0,0,1,1
가격 걱정 불필요,기타,1,0,0,1
"가격 990,000원",제품 구매 및 가격,0,0,1,1
"가격 980,000원",가격 및 거래,0,0,1,1
"가격 970,000원",제품 구매 및 가격,0,0,1,1
"가격 965,000원",가격 및 결제,0,0,1,1
"가격 920,000원",가격 및 거래,0,0,1,1
"가격 90,000원",가격 및 거래,0,0,1,1
"가격 1,110,000원",가격 및 거래,0,0,1,1
"가격 1,100,000 원",가격 및 거래,0,0,1,1
"가격 1,090,000만원",가격 및 구매,0,0,1,1
USB 연결 가능,사용자 편의 및 기능,0,0,1,1
USB 단자 전원 공급,제품 기능 및 성능,1,0,0,1
USB C타입 HDMI 연결,기타,0,0,1,1
URL 제공,기타,0,0,1,1
Thinq 앱 사용,기술 및 기능,0,0,1,1
ThinQ 홈 UI,기타,0,0,1,1
ThinQ 앱으로 배경화면 업로드 가능,기타,0,0,1,1
ThinQ 앱으로 배경화면 설정,제품 기능 및 성능,0,0,1,1
The Standells 노래 떼창 묘사,기타,0,0,1,1
TV와 스탠바이미 중 선택 고민,제품 비교 및 선택 고민,0,0,1,1
TV와 스탠드 결합 안전,기술 및 기능,0,0,1,1
TV와 다른 매력,제품 특징 및 비교,1,0,0,1
TV에 대한 관심 증가,기타,1,0,0,1
TV없는 집에서 사용,제품 적합성 및 사용 장소,1,0,0,1
TV보다 좋음,제품 성능,1,0,0,1
TV로 사용 우려,기타,0,1,0,1
TV/모니터 크기 및 하중,제품 특성 및 기능,0,0,1,1
TV 한 대 있는 경우 추천,사용 환경 및 목적,1,0,0,1
TV 필요성 고민,기타,0,0,1,1
TV 프로그램 재미 부족,기타,0,1,0,1
USB 메모리 연결,기능 및 호환성,0,0,1,1
USB 포트 지원,연결 및 호환성,1,0,0,1
"가격 1,063,000원",기타,0,0,1,1
USB-C 포트 충전,제품 기능 및 성능,0,0,1,1
"가격 1,030,000원",가격 및 상태,0,0,1,1
ㄱ자 형태 숙소,디자인 및 스타일,0,0,1,1
webOS22 탑재,제품 및 기능,0,0,1,1
webOS 플랫폼 지원,플랫폼 및 기술 지원,0,0,1,1
webOS 탑재,플랫폼 및 호환성,1,0,0,1
webOS 6.0 운영체제 탑재,제품 스펙 및 기능,0,0,1,1
webOS 22 운영체제,제품 기능 및 연결성,0,0,1,1
s급 상태,제품 상태 및 제조 정보,0,0,1,1
iPad mini 제공,기타,0,0,1,1
iOS 에어플레이 사용 제한,기술 및 기능,0,1,0,1
iOS 기반,기타,0,0,1,1
Wifi 연결,기능 및 사용 편의성,1,0,0,1
WebOS 플랫폼 지원,플랫폼 및 호환성,1,0,0,1
VR 및 닌텐도 스위치 연결,기타,1,0,0,1
VIP 쿠폰 증정,제품 판매 및 혜택,0,0,1,1
VHS/DVD 출시,영화 및 문화,0,0,1,1
VESA 규격,제품 특성 및 기능,0,0,1,1
VESA 간격,제품 디자인 및 기능,0,0,1,1
USB로 사진 보기,제품 기능 및 사용성,0,0,1,1
뒷면 색상,기타,0,0,1,1
듀얼 모니터 기능,기능 및 성능,1,0,0,1
스탠바이미고 미개봉 새상품,제품 상태 및 판매,0,0,1,1
소형 TV,기타,0,0,1,1
손님이 계속 들어옴,기타,0,0,1,1
손님용 노래 재생,사용 환경 및 용도,0,0,1,1
손님 방문 시 사용,사용 환경 및 설치,0,0,1,1
손님 만족도 궁금,기타,0,0,1,1
손가락 통증,기타,0,1,0,1
소형창문 설치 가능,제품 성능 및 기능,0,0,1,1
소형 포터블 TV,기타,0,0,1,1
소형 평수 거주자 의견 필요,사용 및 설치 환경,0,0,1,1
소형 사이즈,디자인 및 크기,0,0,1,1
소프트웨어 업데이트 소식,플랫폼 및 기술 지원,0,0,1,1
소리 사용 방법,설치 및 사용 불편,0,0,1,1
소중한 순간 공유,기타,0,0,1,1
소장 욕구,제품 디자인 및 구조,1,0,0,1
소장 가치 있는 체험,고객 경험 및 만족도,0,0,1,1
소유권 이전,고객 서비스 및 지원,1,0,0,1
소비자와 브랜드 간 유대감,기타,1,0,0,1
소비 욕심,기타,0,0,1,1
소모 전력,기술 및 기능,0,0,1,1
소리가 뒤로 안감,제품 기능 및 사양,1,0,0,1
소리 재생,제품 기능 및 사용성,1,0,0,1
손색없는 디자인,인테리어 및 디자인,1,0,0,1
손쉬운 터치 사용,사용 만족 및 편의성,1,0,0,1
손잡이로 이동 가능,이동성과 휴대성,0,0,1,1
손잡이로 휴대 용이,휴대성과 보관,1,0,0,1
수요 증가,제품 출시 및 리뷰,0,0,1,1
수수료 지원,기타,0,0,1,1
수수료,부가 서비스 및 결제,0,0,1,1
수백번 테스트,기능 및 성능,0,0,1,1
수면 시 상체 높임,기타,1,0,0,1
수면 도움,라이프스타일 및 경험,1,0,0,1
수리 어려움,기타,0,1,0,1
수량 2개,기타,0,0,1,1
수납포켓,제품 및 액세서리,0,0,1,1
수납부피 문제,공간 및 휴대성 문제,0,1,0,1
수납박스 위 사용 고려,사용자 경험,0,0,1,1
수납공간,공간 및 휴대성 문제,1,0,0,1
수납 케이스 포함,제품 디자인 및 기능,0,0,1,1
수납 케이스,기타,0,0,1,1
숏폼 영상 시청,사용자 경험 및 기능,1,0,0,1
송도1동 거래 희망,거래 및 지역 관련,0,0,1,1
솔캠 세팅 만족,제품 활용 및 기능,1,0,0,1
솔로 캠핑 사용,캠핑 및 휴대성,0,0,1,1
솔드아웃 성공,구매 과정,1,0,0,1
소리 작을 우려,기타,0,1,0,1
소리 문제,기타,0,1,0,1
스탠드 인기,기타,1,0,0,1
세로 모드,제품 기능 및 성능,1,0,0,1
세로 티비,구성 및 설치,0,0,1,1
세로 콘텐츠 시청,제품 특성 및 기능,0,0,1,1
세로 전환 가능,제품 기능 및 사양,1,0,0,1
세로 영상 시청,기타,0,0,1,1
세로 스탠으로 화면 잘 보임,기타,1,0,0,1
세로 모드 지원,제품 특성 및 기능,0,0,1,1
세로 모드 시청,제품 기능 및 성능,1,0,0,1
세로 모드 미지원,제품 기능 및 성능,0,1,0,1
세로 모드 높이 조절 가능,제품 기능 및 사용성,0,0,1,1
세련된 외형,제품 디자인 및 이동성,1,0,0,1
소니 모니터 사용,기타,0,0,1,1
세련된 외관,디자인 및 외관,1,0,0,1
세련된 영상미,영화 관련,1,0,0,1
세련된 색상,제품 디자인 및 크기,1,0,0,1
세계적인 관심,제품 및 브랜드 인식,1,0,0,1
성장영화의 명작으로 칭송,영화 및 미디어,1,0,0,1
성장 소설로 잘 알려짐,기타,0,0,1,1
성인영어회화 하프스터디 신청 혜택,기타,1,0,0,1
성원에 보답,기타,0,0,1,1
성능에 대한 관심,기능 및 사용,0,0,1,1
세로 화면 지원,기능 및 성능,1,0,0,1
세로 회전 피벗 기능,제품 기능 및 성능,1,0,0,1
세로모드,기타,0,0,1,1
세리프 티비,구성 및 설치,0,0,1,1
소년들의 이야기,기타,0,0,1,1
소년들의 여행,문화 및 이벤트,0,0,1,1
"소공동, 을지로, 명동 거래 가능",판매 및 거래,0,0,1,1
셋탑박스 설치 고민,기타 기능 및 옵션,0,0,1,1
셋탑박스 HDMI 연결 필요,연결 및 설치,0,0,1,1
셀프스토리지 사용,사용 환경 및 장소,0,0,1,1
셀프 제작 스탠바이미,기타,0,0,1,1
셀럽 인기,브랜드 및 인기,1,0,0,1
센세이셔널한 등장,기타,1,0,0,1
세트 할인,가격 및 구매 고려,1,0,0,1
세트 제품 활용,기타,1,0,0,1
세탁소 방문 감소,가전 및 생활,0,0,1,1
세탁기•건조기 일체형 모델,LG전자 및 가전제품,0,0,1,1
세컨드TV 혁신,기타,0,0,1,1
세컨드 TV 용도,사용 용도 및 기능,0,0,1,1
세컨 티비 고려,사용 환경 및 목적,0,0,1,1
세일 정보,기타,0,0,1,1
세울 수 있는 구조 필요,디자인 및 공간 활용,0,1,0,1
세리프tv,기타,0,0,1,1
숙면에 도움,기타,1,0,0,1
숙소 여행에서 사용,특정 사용자 및 활용 사례,0,0,1,1
술 마시지 않음,기타 제품 및 서비스,0,0,1,1
스타벅스 아메리카노 쿠폰,부가 서비스 및 혜택,1,0,0,1
스탠 바이 미 도라에몽 5주 연속 1위,영화 관련,1,0,0,1
스탠 바이 미 노래,영화 및 문화,0,0,1,1
스탠 바이 미 곡,기타,0,0,1,1
스타일러와 스탠바이미 비교,구매 및 선택 고민,0,0,1,1
스타일러 렌탈,가전 및 생활,0,0,1,1
스타일러 금액,기타,0,0,1,1
스타벅스 쿠폰 확률 높음,이벤트 및 프로모션,0,0,1,1
스타벅스 아이스 아메리카노 제공,마케팅 및 프로모션,1,0,0,1
스타벅스 아메리카노 쿠폰 증정,마케팅 및 프로모션,0,0,1,1
스타벅스 매장음악 재생,음향 및 사운드,1,0,0,1
숨은 정부 지원금,기타,0,0,1,1
"스크린, 스탠드, 스피커 일체형",기능 및 기술,0,0,1,1
스크린 터치 가능,제품 성능 및 기능,0,0,1,1
스크린 세우기 및 회전 가능,제품 스펙 및 기능,0,0,1,1
스크린 미러링 가능,기능 및 성능,0,0,1,1
스크린 경험,제품 기능 및 성능,0,0,1,1
스크래치 방지,보호 및 내구성,0,0,1,1
스케줄 조정 필요,사용 및 활용,0,0,1,1
스마트홈의 시작,사용 만족 및 편의성,1,0,0,1
스마트한 스탠드형 TV,스탠드 및 설치 관련,0,0,1,1
스탠 바이 미 명작,기타,1,0,0,1
스탠 바이 미 영화,영화 및 문화,0,0,1,1
스탠 바이 미 줄거리,영화 및 콘텐츠,0,0,1,1
스탠 바이 미와 포켓몬스터 게임 관련,라이프스타일 및 경험,0,0,1,1
스탠드 연결,기타,0,0,1,1
스탠드 없음,제품 활용 및 기능,0,1,0,1
스탠드 설치형,제품 특징 및 사용,0,0,1,1
스탠드 설치 용이,기타,1,0,0,1
스탠드 설치 어려움,스탠드 및 설치 관련,0,1,0,1
스탠드 설치,공간 활용 및 설치,0,0,1,1
스탠드 사용 애매함,공간 및 휴대성 문제,0,1,0,1
스탠드 사용 가능,기타,0,0,1,1
스탠드 불필요,제품 비교 및 기타,1,0,0,1
스탠드 별도 구매 가능성,제품 기능 및 사양,0,0,1,1
스탠드 번거로움 없음,기타,1,0,0,1
스탠드 무빙,스탠드 및 설치 관련,0,0,1,1
스탠드 무거움,디자인 및 구조,0,1,0,1
스탠드 높이 조절 부족,제품 사용 및 설치,0,1,0,1
스탠드 높이 조절 가능,기능 및 성능,1,0,0,1
스탠드 높이 조절,기타,0,0,1,1
스탠드 결합 사용,스탠드 및 화면 조절,0,0,1,1
스탠드 거치대 사용,연결 및 설치,0,0,1,1
스탠드 vs 캐리백 수납함,제품 및 액세서리,0,0,1,1
스마트폰보다 큰 화면,제품 특성 및 디자인,1,0,0,1
스마트폰과 TV 연결 편리,제품 기능 및 사용성,1,0,0,1
스마트폰 컨텐츠 시청,엔터테인먼트 및 콘텐츠,1,0,0,1
스마트 터치 스크린,스탠바이미 제품,0,0,1,1
스마트 스탠드 TV,제품 기능 및 사용성,1,0,0,1
스마트 스크린 터치,이동식 TV 및 포터블 스크린,0,0,1,1
스마트 스크린,플랫폼 및 기술 지원,1,0,0,1
스마트 마운트,제품 기능 및 사용성,0,0,1,1
스마트 디스플레이와 호환,기타 기능 및 특징,0,0,1,1
"스마트 기능: 넷플릭스, 유튜브",제품 스펙 및 기술,0,0,1,1
스마트 TV 유행,기타,0,0,1,1
스마트 TV 앱 사용,제품 특징 및 사용,0,0,1,1
스다 마사키 주제가 참여,문화 및 엔터테인먼트,0,0,1,1
스노우피크와 콜라보레이션,제품 출시 및 이벤트,0,0,1,1
스노우피크 팝업 구매 이벤트,기타,0,0,1,1
쉽고 편리한 폴터치 스크린,이동 및 사용 편의성,1,0,0,1
쉽게 이동 가능,휴대성과 이동성,1,0,0,1
쉽게 구매,기타,1,0,0,1
쉬운 화면 이동,기타,1,0,0,1
쉬운 열고 닫기,제품 기능 및 사용성,1,0,0,1
쉬운 모니터 연결,사용자 편의 및 기능,1,0,0,1
쉬운 높이 조절,제품 설치 및 사용 환경,1,0,0,1
숲 속 촬영,광고 및 홍보,0,0,1,1
스마트 연결 및 조작 편의성,제품 기능 및 성능,1,0,0,1
스마트TV,제품 및 기능 만족,0,0,1,1
스마트폰 영상 시청,기타,0,0,1,1
스마트TV 여부,사용 편의성 및 기능,0,0,1,1
스마트폰 연동,기능 및 사용성,0,0,1,1
스마트폰 연결 가능,제품 기능 및 성능,1,0,0,1
스마트폰 연결,편의성과 활용,1,0,0,1
스마트폰 시청 불편,기타,0,1,0,1
스마트폰 사업 종료,기타,0,0,1,1
스마트폰 미러링 기능,다양한 기능 및 설정,0,0,1,1
스마트폰 미러링 가능,제품 기능 및 사용성,1,0,0,1
스마트폰 미러링,기능 및 기술,0,0,1,1
스마트폰 대신 사용,기타,1,0,0,1
스마트폰 거치대,제품 활용 및 기능,1,0,0,1
스마트폰 거치 스탠드 제공,기타,0,0,1,1
스마트티비 고려,제품 특징 및 활용,0,0,1,1
스마트스토어 및 앱에서 판매,기타,0,0,1,1
스마트스크린,기타,0,0,1,1
스마트뷰 제한,콘텐츠 및 사용성,0,1,0,1
스마트모니터 화면 크기 고민,기능 및 사용,0,0,1,1
스마트모니터 M7 32인치,제품 디자인 및 기능,0,0,1,1
스마트디바이스 기능,제품 및 기술 사양,0,0,1,1
스마트TV 플랫폼,제품 기능 및 성능,0,0,1,1
성능 평가,제품 사용 경험 및 평가,0,0,1,1
성능 정보,제품 정보 및 추천,0,0,1,1
성능 및 특징 정보,기타,0,0,1,1
상품 맞지 않음,구매 및 거래,0,1,0,1
상품 판매,제품 및 가격 정보,0,0,1,1
상품 특징 정보 제공,제품 정보 및 추천,0,0,1,1
상품 증정,이벤트 및 프로모션,0,0,1,1
상품 정보 제공,기타 기능 및 고민,0,0,1,1
상품 정보 정리,제품 정보 및 혜택,0,0,1,1
상품 정보,기타,0,0,1,1
상품 수령예정,제품 구매 및 거래,0,0,1,1
상품 상세 정보,기타,0,0,1,1
상품 불만족,제품 평가 및 후기,0,1,0,1
상품 노출 안내,기타,0,0,1,1
새로운 폼팩터 TV 출시,혁신 및 업그레이드,0,0,1,1
상품 게시글 자동 노출,기타,0,0,1,1
상태 확인 후 재포장,제품 구매 및 거래,0,0,1,1
상태 최상,제품 및 가격 정보,0,0,1,1
상영시간 88분,기타,0,0,1,1
상세한 제품 설명,기타,1,0,0,1
상세한 성능 및 특징 공유,제품 정보 및 추천,0,0,1,1
상세 정보 및 스펙,제품 정보 및 혜택,0,0,1,1
상세 스펙과 정보 제공,기능 및 사용,0,0,1,1
상세 스펙 및 정보 제공,제품 정보 및 추천,0,0,1,1
상품권 제공,이벤트 및 프로모션,0,0,1,1
상품명,기타,0,0,1,1
상품명 스탠바이미 고,기타,0,0,1,1
상품명 스탠바이미go,제품 및 가격 정보,0,0,1,1
새로운 제품,기타,0,0,1,1
새로운 아이디어,기타,1,0,0,1
새로운 세트 구성,기타,0,0,1,1
새로운 디자인,기타,1,0,0,1
새끼 고양이 사용,기타,0,0,1,1
새것과 같은 상태,가격 및 상태,1,0,0,1
새것 같은 상태,제품 상태 및 구성,1,0,0,1
새 제품 배송,기타,0,0,1,1
새 제품 단순 개봉,가격 및 상태,0,0,1,1
새 제품 구입,부가 정보 및 기타,1,0,0,1
새 제품 구매 고민,구매 및 가격 고민,0,0,1,1
새 상품 구매,제품 상태 및 판매,0,0,1,1
상품평 많음,기타,0,0,1,1
상품명: 엘지 스탠바이미고,기타,0,0,1,1
상품명: 엘지 스탠바이미 신형 27ART10CMPL,기타,0,0,1,1
상품명: 스탠바이미고,제품 및 가격 정보,0,0,1,1
상품명: LG 포터블 스크린 스탠바이미고,기타,0,0,1,1
상품명: LG 스탠바이미 Go 챔피언에디션,기타,0,0,1,1
상품명: LG 스탠바이미,기타,0,0,1,1
상담 고려,기타,0,0,1,1
상단부 스피커,기타,0,0,1,1
상단부 각도 조정 가능,기타,1,0,0,1
삼성과 비교,기타,0,0,1,1
삼성 태블릿과 스탠바이미 Go 기회,사은품 및 이벤트,0,0,1,1
삼성 직배송,기타,0,0,1,1
삼성 제품 비교,기타,0,0,1,1
삼성 정품 이동식 스탠드,브랜드 및 이벤트,0,0,1,1
삼성 스탠바이미 m7,스탠바이미 및 스마트 모니터 관련,0,0,1,1
삼성 스탠바이미 M7,기타,0,0,1,1
삼성 스탠바이미 32인치 M7 4K,기타,0,0,1,1
삼성 스탠바이미 32인치 IPTV M5 스마트 모니터,스탠바이미 및 스마트 모니터 관련,0,0,1,1
삼성 스탠바이미 32인치,기타,0,0,1,1
삼성 스마트모니터 가격 할인,기타,1,0,0,1
삼성 스마트모니터 M7 가격,가격 및 구매,0,0,1,1
삼성 스마트 모니터 M7 화질 우수,화질 및 성능,1,0,0,1
삼성 세로티비 렌탈,기타,0,0,1,1
삼성 세로 디자인,기타,0,0,1,1
삼성 삼탠바이미 후속 제품,기타,0,0,1,1
삼성 삼탠바이미 주목,인기 및 시장 반응,0,0,1,1
삼성 삼탠바이미 가성비,기타,0,0,1,1
삼성 무빙스탠드 M7 할인,제품 비교 및 차별성,0,0,1,1
삼성 무빙 스탠드 발표,브랜드 및 광고,0,0,1,1
삼성TV 별도 거치대 세트,제품 호환 및 액세서리,0,0,1,1
삼성의 신제품 기대,제품 홍보 및 출시 기대,0,0,1,1
삼텐바이미 저렴한 가격,기타,1,0,0,1
삼성전자 32인치 IPTV M5 스마트 모니터,기술 및 기능,0,0,1,1
삼텐바이미 유선 사용 필수,제품 기능 및 성능,0,0,1,1
삼텐바이미 가성비,기타,0,0,1,1
삼텐바이미 4k,제품 기능 및 성능,0,0,1,1
삼탠바이미와 가격 차이,제품 구매 및 가격,0,0,1,1
삼탠바이미·중소바이미 비교,기타,0,0,1,1
삼탠바이미 호환,기술 및 기능,0,0,1,1
삼탠바이미 저렴한 가격,기타,1,0,0,1
삼탠바이미 설명,브랜드 및 광고,0,0,1,1
삼탠바이미 선택 증가,사용 경험 및 인기,0,0,1,1
삼탠바이미 사용 가능,기타,0,0,1,1
삼탠바이미 사양,제품 기능 및 성능,0,0,1,1
삼탠바이미 리뷰 많음,고객 만족 및 리뷰,0,0,1,1
삼탠바이미 또는 중텐바이미 고려,기타,0,0,1,1
삼탠바이미 구매 고민,기타,0,0,1,1
삼탠바이미 거치대,기타,0,0,1,1
삼탠바이미 가성비 좋음,구매 고려 및 비교,1,0,0,1
삼탠바이미,기타,0,0,1,1
삼성카드 결제,제품 구매 및 가격,0,0,1,1
삼성전자 32인치 스마트 IPTV,제품 기능 및 사양,0,0,1,1
새로운 컨셉 시도,기타,0,0,1,1
새상품 소개,제품 및 가격 정보,0,0,1,1
성능 및 특징 궁금증,제품 기능 및 성능,0,0,1,1
선물 제공,이벤트 및 참여,0,0,1,1
선재 없음,기타,0,1,0,1
선입금 요구 사기 주의,가격 및 거래,0,1,0,1
선박이사로 보낼 수 있는지 궁금,기타,0,0,1,1
선물용 미개봉 구입,추천 및 계획,0,0,1,1
선물용 구매,구매 및 거래,1,0,0,1
선물로 적합,제품의 장점 및 추천,1,0,0,1
선물로 스탠바이미 원함,스탠바이미 관련,1,0,0,1
선물로 받은 스탠바이미,사용 경험 및 후기,1,0,0,1
선물과 이벤트,이벤트 및 참여,1,0,0,1
선명한 음질,기타,1,0,0,1
새상품/미개봉,제품 상태 및 구성,0,0,1,1
선명하고 생생한 화면,화질 및 화면,1,0,0,1
선 정리 어려움,제품 특성 및 기능,0,1,0,1
석관동 거래,기타,0,0,1,1
서촌의 숨겨진 장소,기타,1,0,0,1
서촌와인바 스탠바이미 방문,기타,0,0,1,1
서촌 저녁 데이트 장소,기타,1,0,0,1
서촌 위치,위치 및 환경,0,0,1,1
서촌 와인바 추천,기타,1,0,0,1
서촌 와인바 방문,기타,0,0,1,1
선착순 등록,구매 및 가격 혜택,0,0,1,1
선착순 증정,가격 및 프로모션,1,0,0,1
선착순 혜택,제품 구매 및 경제성,0,0,1,1
선택폭 넓힘,기타,0,0,1,1
성능 및 특징 공유,기타,0,0,1,1
성능 대비 가격,제품 및 기능 만족,0,1,0,1
성능 기대 이하,제품 기능 및 사양,0,1,0,1
성공적인 제품,제품 만족도,1,0,0,1
섬세한 감수성,영화 관련,1,0,0,1
설치기사 방문,고객 서비스 및 지원,0,0,1,1
설치 확인,기타,0,0,1,1
설치 추천,배송 및 설치,0,0,1,1
설치 용이,기타,1,0,0,1
설치 어려움,제품 설치 및 이동 문제,0,1,0,1
설치 서비스 미제공,기타,0,1,0,1
설치 서비스 만족,기타,1,0,0,1
설치 서비스,이동성과 설치,0,0,1,1
설치 불안감,사용 환경 및 설치,0,1,0,1
설치 번거로움,제품 사용 및 설치,0,1,0,1
설치 기사 방문 필요,기타,0,0,1,1
설치 간편,이동 및 설치 용이성,1,0,0,1
설정 용이,사용 편의성,1,0,0,1
설정 가능 여부 궁금,제품 사용 및 기능,0,0,1,1
서촌 데이트 코스로 유명,기타,0,0,1,1
서촌 데이트 코스 추천,사회 및 커뮤니티,1,0,0,1
서촌 데이트 코스,기타,1,0,0,1
샤넬,기타,0,0,1,1
생활 속 간편함,사용 만족 및 편의성,1,0,0,1
생활 변화,기타,1,0,0,1
생활 기스 있음,사용 경험 및 평가,0,0,1,1
생활 기스,제품 상태 및 사용,0,0,1,1
생체인식,보안 및 안전,1,0,0,1
생일선물 쿠폰 사용,특정 상황 및 용도,0,0,1,1
생일선물 고민,사용자 경험,0,0,1,1
생일 선물,기타,1,0,0,1
생산일,기타,0,0,1,1
생산성 향상,제품 평가 및 후기,1,0,0,1
생산성 극대화,제품 특징 및 사용성,0,0,1,1
생산 연도,기타,0,0,1,1
생동감 있는 라이딩 체험,기능 및 성능,1,0,0,1
색상과 라인 다름,제품 상태 및 포장,0,0,1,1
색다름,제품 특성 및 디자인,1,0,0,1
색다른 인테리어,디자인 및 공간 활용,1,0,0,1
색다른 분위기,기타,1,0,0,1
색다른 디자인,디자인 및 혁신,1,0,0,1
새제품 상태,제품 상태 및 포장,1,0,0,1
생활 편의성 향상,사용 만족 및 편의성,1,0,0,1
서류 가방 형식,기타,0,0,1,1
서촌 LP바 소개,장소 및 분위기,0,0,1,1
서류 제공 가능,기타,0,0,1,1
서촌 LP바 방문,기타,0,0,1,1
서재에서 듀얼모니터로 사용,사용 경험,0,0,1,1
서울대 출신 연구진 제작,기타,1,0,0,1
서울대 출신 연구진 개발,교육 및 학습,0,0,1,1
서울대 연구진 개발,부가 정보 및 기타,1,0,0,1
서울 지역 거래 제한,거래 및 구매 관련,0,0,1,1
서울 외 지역 거래 가능,지역 및 거래 조건,0,0,1,1
서울 실내 데이트 장소,기타,0,0,1,1
서울 상암동 거래,가격 및 거래,0,0,1,1
서울 데이트 추천,기타,1,0,0,1
서울 근교 이동 가능,가격 및 거래,1,0,0,1
서울 강북구 번동 직거래 가능,거래 및 배송,0,0,1,1
서비스 종료 메시지,기타 이슈 및 요구,0,1,0,1
서비스 기간 2024년 8월까지,사용자 경험,0,0,1,1
서비스,제품 결함 및 서비스,0,0,1,1
서브모니터,이동식 TV 및 포터블 스크린,0,0,1,1
서브 TV 및 모니터로 사용,제품 및 모델 비교,1,0,0,1
서류가방 형태 GO,이동성과 휴대성,0,0,1,1
서류가방 형태,기타,1,0,0,1
스탠드 원반 무거움,디자인 및 구조,0,1,0,1
스탠드 일체형 디자인,제품 기능 및 사용성,0,0,1,1
삼성 모니터 및 거치대 사용,기타,0,0,1,1
스탠바이미 스피커 포함,기능 및 성능,0,0,1,1
스탠바이미 영상 공개,엔터테인먼트 및 콘텐츠,0,0,1,1
스탠바이미 어댑터 인기,제품 특성 및 기능,0,0,1,1
스탠바이미 앱 자주 이용,기타,0,0,1,1
스탠바이미 액정보호필름,제품 및 액세서리,0,0,1,1
스탠바이미 액정보호,기타,0,0,1,1
스탠바이미 신혼집 고려,구매 고려 및 비교,0,0,1,1
스탠바이미 신품,기타,0,0,1,1
스탠바이미 시청 만족,스탠바이미 제품 및 기능,1,0,0,1
스탠바이미 시리즈 전시,제품 및 브랜드 인식,0,0,1,1
스탠바이미 스피커 페어링 방법,기타,0,0,1,1
스탠바이미 소개,스탠바이미 제품,0,0,1,1
스탠바이미 스피커 추가,제품 특성 및 기능,0,0,1,1
스탠바이미 스피커 좋음,제품 사용 경험 및 평가,1,0,0,1
스탠바이미 스피커 설치,기타,0,0,1,1
스탠바이미 스피커 구매,기타,0,0,1,1
스탠바이미 스피커 XT7S 공개,사운드 및 영상 품질,0,0,1,1
스탠바이미 스마트티비 탐남,제품 특징 및 활용,1,0,0,1
스탠바이미 수요 증가,스탠바이미 제품 관련,0,0,1,1
스탠바이미 수상,브랜드 및 모델,1,0,0,1
스탠바이미 소유 욕구,제품 및 기능,0,0,1,1
스탠바이미 영화,영화 및 문화,0,0,1,1
스탠바이미 영화 다시보기,기타,0,0,1,1
스탠바이미 외관,외관 및 디자인,0,0,1,1
스탠바이미 운반 가능 여부,제품 설치 및 이동,0,0,1,1
스탠바이미 제품 사용,기타,0,0,1,1
스탠바이미 제품 다양성,스탠바이미 제품 관련,0,0,1,1
스탠바이미 제작,신제품 및 모델,0,0,1,1
스탠바이미 제외,구매 및 소비,0,0,1,1
스탠바이미 정보 검색,제품 특징 및 활용,0,0,1,1
스탠바이미 정보,제품 정보 및 출시,0,0,1,1
스탠바이미 전용 스피커,플랫폼 및 기술 지원,0,0,1,1
스탠바이미 전용,기타,1,0,0,1
스탠바이미 전시,제품 모델 및 출시,0,0,1,1
스탠바이미 장기 사용자,기타,1,0,0,1
스탠바이미 입구,기타,0,0,1,1
스탠바이미 이벤트 참여,프로모션 및 혜택,1,0,0,1
스탠바이미 이벤트 당첨,이벤트 및 프로모션,1,0,0,1
스탠바이미 이벤트,개인 사정 및 기타,0,0,1,1
스탠바이미 이동 사용 고려,설치 및 이동성,0,0,1,1
스탠바이미 이동,이동식 TV 및 포터블 스크린,1,0,0,1
스탠바이미 유용성,제품 기능 및 성능,1,0,0,1
스탠바이미 위시리스트 제품,구매 및 이벤트,1,0,0,1
"스탠바이미 월 30,277원",기타,0,0,1,1
스탠바이미 소리 무난,제품 기능 및 성능,0,0,1,1
스탠바이미 설치 예정,제품 설치 및 이동,0,0,1,1
스탠드 조작성 아쉬움,성능 아쉬움,0,1,0,1
스탠바이미 마케팅,기타,0,0,1,1
스탠바이미 미사용,기타,0,0,1,1
스탠바이미 미러링,제품 특성 및 용도,0,0,1,1
스탠바이미 뮤직박스,기타,0,0,1,1
스탠바이미 무선 사용 가능,제품 기능 및 성능,0,0,1,1
스탠바이미 모방 제품,제품 디자인 및 이동성,0,0,1,1
스탠바이미 모델명 27ART10DKPL 판매,제품 상태 및 제조 정보,0,0,1,1
스탠바이미 메인 TV 고민,사용 용도 및 환경,0,0,1,1
스탠바이미 매입,제품 및 브랜드 인식,0,0,1,1
스탠바이미 만족도 높음,고객 경험 및 만족도,1,0,0,1
스탠바이미 리뷰,제품 기대 및 스펙,0,0,1,1
스탠바이미 설치,사용 경험,0,0,1,1
스탠바이미 렌탈 기회,제품 설치 및 사용 환경,0,0,1,1
스탠바이미 렌탈 관심,기타,0,0,1,1
스탠바이미 러브 이벤트,사용 경험 및 인기,0,0,1,1
스탠바이미 러버 이벤트,이벤트 및 혜택,0,0,1,1
스탠바이미 러버 스티커,제품 정보 및 출시,0,0,1,1
스탠바이미 디자인 선호,디자인 및 인테리어,1,0,0,1
스탠바이미 득템 기회,스탠바이미 제품 및 기능,0,0,1,1
스탠바이미 두 가지 형태,제품 특징 및 사용,0,0,1,1
스탠바이미 두 가지 제품,렌탈 및 구매 옵션,0,0,1,1
스탠바이미 및 스탠바이미 고 렌탈 가능,렌탈 및 구매 옵션,0,0,1,1
스탠바이미 및 스탠바이미Go,기타,1,0,0,1
스탠바이미 받기,구매 및 사용 경험,0,0,1,1
스탠바이미 방송 첫선,스탠바이미 제품,0,0,1,1
스탠바이미 선반,제품 특성 및 기능,0,0,1,1
스탠바이미 새제품 보유,구매 및 거래,0,0,1,1
스탠바이미 상품,기타,0,0,1,1
스탠바이미 상담 및 구매,고객 서비스 및 지원,0,0,1,1
스탠바이미 사이즈 티비 필요,제품 특징 및 비교,0,0,1,1
스탠바이미 사은품 이벤트,부가 서비스 및 혜택,1,0,0,1
스탠바이미 사은품,가격 및 구매,0,0,1,1
스탠바이미 사용자 바이브,디자인 및 외관,0,0,1,1
스탠바이미 사용 증가,특정 상황 및 용도,0,0,1,1
스탠바이미 사용 예상,제품 만족도 및 홍보,1,0,0,1
스탠바이미 사용 여부 궁금,기능 및 사용,0,0,1,1
스탠바이미 사용 빈도 높음,기타,1,0,0,1
스탠바이미 사용 문의,스탠바이미 제품 관련,0,0,1,1
스탠바이미 사용 고려,제품 정보 및 추천,0,0,1,1
스탠바이미 사용 경험,사용 경험 및 인기,0,0,1,1
스탠바이미 사용 가능성 문의,기타,0,0,1,1
스탠바이미 사양,제품 기능 및 성능,0,0,1,1
스탠바이미 브랜드 인기,브랜드 및 트렌드,1,0,0,1
스탠바이미 보통명사화,제품 모델 및 출시,0,0,1,1
스탠바이미 제품 의문,스탠바이미 제품 및 기능,0,0,1,1
스탠바이미 제품 인기,제품 만족도,1,0,0,1
스탠바이미 제품 판매,스탠바이미 관련,0,0,1,1
스탠바이미Go 체험 이벤트 당첨,프로모션 및 이벤트,0,0,1,1
스탠바이미go 챔피언에디션,제품 특징 및 구성,0,0,1,1
스탠바이미go 사용 후기,기타,0,0,1,1
스탠바이미go 보관 박스,기타 기능 및 옵션,0,0,1,1
스탠바이미go 기내 수하물 가능,캠핑 및 휴대성,1,0,0,1
스탠바이미go 경험,제품 출시 및 이벤트,0,0,1,1
스탠바이미go 거치 가능성,사용 환경 및 설치,0,0,1,1
스탠바이미TV에 대한 관심 증가,기타,0,0,1,1
스탠바이미TV 구매 이유 이해,기타,1,0,0,1
스탠바이미Go 포터블,제품 휴대성과 이동성,0,0,1,1
스탠바이미Go 제품,제품의 장점 및 추천,0,0,1,1
스탠바이미 증정,기타,1,0,0,1
스탠바이미Go 소감,기타,0,0,1,1
스탠바이미Go 디스플레이,화질 및 디스플레이,0,0,1,1
스탠바이미Go 구매,기타,0,0,1,1
스탠바이미Go 2023 vs 2024 비교,브랜드 및 트렌드,0,0,1,1
스탠바이미Go,제품 특성 및 용도,0,0,1,1
스탠바이미GO 패키지 런칭,이벤트 및 프로모션,0,0,1,1
스탠바이미GO 테이블 추천,기타,1,0,0,1
스탠바이미GO 테이블 변신,기타,0,0,1,1
스탠바이미GO 테이블,제품 특징 및 구성,0,0,1,1
스탠바이미go 판매,제품 특징 및 활용,0,0,1,1
스탠바이미go에 대한 관심,마케팅 및 커뮤니티 반응,0,0,1,1
스탠바이미go와 삼성 스마트 모니터 비교,스탠바이미 및 스마트 모니터 관련,0,0,1,1
스탠바이미go와 하프스터디 유명,기타,1,0,0,1
스탠바이미고 미개봉 상품,제품 및 가격 정보,0,0,1,1
스탠바이미고 모델 차이 및 장점,제품 비교 및 평가,0,0,1,1
스탠바이미고 마케팅,제품 특징 및 기능,0,0,1,1
스탠바이미고 렌탈 가능,기타,0,0,1,1
스탠바이미고 렌탈,제품 출시 및 트렌드,0,0,1,1
스탠바이미고 동축케이블 지원,제품 사용 및 기능,0,0,1,1
스탠바이미고 구입 희망,기타,0,0,1,1
스탠바이미고 구매 욕구,기타,0,0,1,1
스탠바이미고 구매 계획,제품 특징 및 사용,0,0,1,1
스탠바이미고 구경,기타,0,0,1,1
스탠바이미고 게임,사용자 경험 및 기능,0,0,1,1
스탠바이미고 거치 가능성,사용 용도 및 환경,0,0,1,1
스탠바이미고 가방 판매,제품 특성 및 용도,0,0,1,1
스탠바이미고 가방 케이스,기타,0,0,1,1
스탠바이미고 TV,기타,0,0,1,1
스탠바이미고 Go 행사,프로모션 및 이벤트,1,0,0,1
스탠바이미고 Go 득템,프로모션 및 이벤트,1,0,0,1
스탠바이미고 2세대 캠핑 인테리어 포터블 27인치 모니터 추천,신제품 및 모델,0,0,1,1
스탠바이미고 2세대 추천,제품 평가 및 기대,1,0,0,1
스탠바이미GO 추천,제품 특징 및 구성,1,0,0,1
스탠바이미GO 제품,제품 및 가격 정보,0,0,1,1
스탠바이미GO 스타일 선호하지 않음,제품 모델 및 출시,0,1,0,1
스탠바이미 프리미엄 가격,스탠바이미 제품 관련,0,0,1,1
스탠바이미 평이 좋음,제품 사용 경험 및 평가,1,0,0,1
스탠바이미 편의성,제품 기능 및 사용성,0,0,1,1
스탠바이미 파티츄 4가지 맛,기타,0,0,1,1
스탠바이미 파생 제품,브랜드 및 인기,0,0,1,1
스탠바이미 특허 침해 소송,스탠바이미 제품 및 기능,0,0,1,1
스탠바이미 트렌드,브랜드 및 트렌드,0,0,1,1
스탠바이미 테이블 거치대 사용,스탠바이미 제품 및 기능,0,0,1,1
스탠바이미 클럽 시즌2 방문,기타,0,0,1,1
스탠바이미 클럽 관심 권장,기타,0,0,1,1
스탠바이미 크기 작음,기타,0,0,1,1
스탠바이미 크기 아쉬움,스탠바이미 제품,0,1,0,1
스탠바이미 크기,제품 특징 및 활용,0,0,1,1
스탠바이미 카페 가입,기타,0,0,1,1
스탠바이미 출시 기념 이벤트,프로모션 및 이벤트,0,0,1,1
스탠바이미 출시 관심,제품 출시 및 관심,0,0,1,1
스탠바이미 출시,기타,0,0,1,1
스탠바이미 추천 여부,기타,0,0,1,1
스탠바이미 체험 가능,기타,0,0,1,1
스탠바이미 챔피언 에디션 미개봉,스탠바이미 관련,0,0,1,1
스탠바이미 품절 현상,제품 구매 및 결정,0,0,1,1
스탠바이미 필요성 의문,제품 성능 및 기능,0,1,0,1
스탠바이미GO 선택,제품 비교 및 선택 고민,0,0,1,1
스탠바이미 할인,가격 및 결제 옵션,0,0,1,1
스탠바이미GO 사이즈 및 컬러,디자인 및 크기,0,0,1,1
스탠바이미2세대 핫딜,스탠바이미 관련,0,0,1,1
스탠바이미2 출시 기대,제품 평가 및 기대,0,0,1,1
스탠바이미2 괜찮음,제품 비교 및 추천,1,0,0,1
스탠바이미2 개봉,스탠바이미 제품 및 기능,0,0,1,1
스탠바이미1 좋음,제품 비교 및 추천,1,0,0,1
스탠바이미1 모델,제품 모델 및 출시,0,0,1,1
스탠바이미+스피커 세트 판매,구매 및 거래,0,0,1,1
스탠바이미 후속 모델 기대,제품 홍보 및 출시 기대,1,0,0,1
스탠바이미 활용성,사용자 경험,1,0,0,1
스탠바이미 활용,제품 특성 및 기능,1,0,0,1
스탠바이미 화질 불만,화질 및 성능,0,1,0,1
스탠바이미 화이트TV 에디션,기타,0,0,1,1
스탠바이미 화면 작음,제품 특징 및 비교,0,1,0,1
스탠바이미 협찬,기타,0,0,1,1
스탠바이미 허리베개 구매,기타,0,0,1,1
스탠바이미 허리베개,기타,0,0,1,1
스탠바이미 해외 배송 가능 여부,기타,0,0,1,1
스탠바이미 해상도,제품 특징 및 활용,0,0,1,1
스탠바이미 도입,기타,0,0,1,1
스탠바이미 도라에몽 1위,제품 정보 및 출시,0,0,1,1
스탠바이미 대체재로 인기,기타,1,0,0,1
스탠바이미 27인치 스마트 TV 소개,제품 특징 및 비교,0,0,1,1
스탠바이미 GO 공개,제품 출시 및 관심,0,0,1,1
스탠바이미 GO,기타,0,0,1,1
스탠바이미 5행시 이벤트,이벤트 및 프로모션,0,0,1,1
스탠바이미 3세대,브랜드 및 모델,0,0,1,1
스탠바이미 2탄 출시,제품 출시 및 이벤트,0,0,1,1
스탠바이미 2세대 출시 정보,제품 정보 및 출시,0,0,1,1
스탠바이미 2세대 출시 가능성,신제품 및 모델,0,0,1,1
스탠바이미 2대 배치 고민,제품 특징 및 활용,0,0,1,1
스탠바이미 27인치 스마트모니터,기타,0,0,1,1
스탠바이미 27인치 모니터,기타,0,0,1,1
스탠바이미 LED TV,기타,0,0,1,1
스탠바이미 27ART10DKPL,구매 및 소비,0,0,1,1
스탠바이미 20대 증정 이벤트 참여,구매 및 이벤트,1,0,0,1
스탠바이미 2024 정보 제공,기타,0,0,1,1
스탠바이미 2024 버전 구입 고민,구매 및 선택 고민,0,0,1,1
스탠바이미 2 출시 대기,스탠바이미 관련,0,0,1,1
스탠바이미 2 개봉 기대,영화 및 문화,0,0,1,1
스탠바이미 1세대 가정에서 사용,기타,0,0,1,1
스탠바이미 1대 이동,제품 특징 및 활용,0,0,1,1
스탠바이미 1 인기,시장 반응 및 인기,0,0,1,1
스탠바이미 GO 관심,기타,1,0,0,1
스탠바이미 GO 구매 추천,제품 추천 및 체험,1,0,0,1
스탠바이미 GO 기대감,기타,0,0,1,1
스탠바이미 GO 사용,교육 및 특별 용도,0,0,1,1
스탠바이미 Go 프로모션 당첨,이벤트 및 프로모션,1,0,0,1
스탠바이미 Go 캠핑에서 사용,이동식 스마트 TV,0,0,1,1
스탠바이미 Go 추천,제품 인기 및 추천,1,0,0,1
스탠바이미 Go 체험 기회,기타,1,0,0,1
스탠바이미 Go 증정,사은품 및 이벤트,0,0,1,1
스탠바이미 Go 이벤트 당첨,사용 경험 및 후기,1,0,0,1
스탠바이미 Go 사용 기회,기타,1,0,0,1
스탠바이미 Go 무료 증정 이벤트,제품 출시 및 이벤트,0,0,1,1
스탠바이미 Go 매력,기타,1,0,0,1
스탠바이미 Go 기대감,제품 구매 및 기대,1,0,0,1
스탠바이미 Go 관심,기타,0,0,1,1
스탠바이미 Go,제품 및 브랜드 인식,0,0,1,1
스탠바이미 GO 행사,이벤트 및 프로모션,0,0,1,1
스탠바이미 GO 할인,구매 및 할인,1,0,0,1
스탠바이미 GO 제품,기타,0,0,1,1
스탠바이미 GO 제공,제품 기대 및 스펙,0,0,1,1
스탠바이미 GO 입고,제품 출시 및 홍보,0,0,1,1
스탠바이미 GO 소개,기타,0,0,1,1
스탠바이미 GO 선호,기타,1,0,0,1
스탠바이모드,제품 활용 및 기능,0,0,1,1
스탠바이를 애정하는 이유 작성,기타,0,0,1,1
스탠바이 미 도라에몽 4주 연속 1위,기타,1,0,0,1
스탠드형 선호,디자인 및 외관,0,0,1,1
스탠드형 및 테이블 모드,제품 활용 및 기능,0,0,1,1
스탠드형 무선 TV,기타,0,0,1,1
스탠드형 모델 고정 위치에 적합,사용자 경험,1,0,0,1
스탠드형 모니터,기능 및 성능,0,0,1,1
스탠드형 렌탈,구매 및 가격,0,0,1,1
스탠드형 구매,제품 특징 및 사용,0,0,1,1
스탠드형 TV 구매,기타,0,0,1,1
스탠드티비 특징 소개,디자인 및 혁신,0,0,1,1
스탠드와 바퀴,디자인 및 구조,0,0,1,1
스탠드와 무선 배터리 탑재,제품 스펙 및 기능,1,0,0,1
스탠드봉에 전선 미리 넣기,제품 스펙 및 기술,0,0,1,1
스탠드/벽걸이 선택 가능,제품 비교 및 선택,0,0,1,1
스탠드 활용,사용 사례 및 추천,1,0,0,1
스탠드 형식 구입,제품 디자인 및 조립,0,0,1,1
스탠드 탑재,구성 및 설치,0,0,1,1
스탠드 퀄리티,제품 디자인 및 기능,0,0,1,1
스탠드 추천,제품 및 기능,1,0,0,1
스탠드 조절 편리,사용 편의성,1,0,0,1
스탠드 조절 기능,사용자 경험 및 만족도,0,0,1,1
스탠드형 방문설치,서비스 및 지원,0,0,1,1
스탠드형 스크린,제품 및 기술 사양,0,0,1,1
스탠바이 모드 전력 절약,부가 기능 및 기타,1,0,0,1
스탠드형 스탠바이미,구성 및 설치,0,0,1,1
스탠바이 모드 오해,기타,0,0,1,1
스탠바이 모드 기능,기능 및 성능,1,0,0,1
스탠바이 기능으로 에너지 절약,기능 및 성능,1,0,0,1
스탠바이 기능,부가 기능 및 기타,1,0,0,1
스탠바리미2 신모델,제품 모델 및 출시,0,0,1,1
스탠딩티비 고려,기타,0,0,1,1
스탠딩 활용 가능,기능 및 성능,1,0,0,1
스탠딩 형식,제품 기능 및 사용성,0,0,1,1
스탠딩 타입 사용 중,기타,1,0,0,1
스탠딩 타입 만족,제품 및 기능 만족,1,0,0,1
스탠딩 책상 개발 및 제조,디자인 및 혁신,0,0,1,1
스탠딩 이동식 TV,이동성과 휴대성,0,0,1,1
스탠딩 데스크 활용,사용 사례 및 추천,0,0,1,1
스탠딩 TV 선택,기타,0,0,1,1
스탠드화이트 32인치 FHD,기타,0,0,1,1
스탠드형과 휴대형 라인업,기타,0,0,1,1
스탠드형과 스탠바이미 고 존재,제품 기능 및 성능,0,0,1,1
스탠드형 스탠바이미 렌탈,기타,0,0,1,1
스탠드형 스탠바이미 고려,제품 디자인 및 이동성,0,0,1,1
스탠바이미 Go의 매력,기타,1,0,0,1
스탠바이미 LG에 대한 높은 관심,스탠바이미 관련,1,0,0,1
스탠바이미 대체 계획,기타,0,0,1,1
스탠바이미 고와 룸앤TV 2세대 스펙 비교,부가 기능 및 기타,0,0,1,1
스탠바이미 구매 계획,TV 구매 및 사용 고민,0,0,1,1
스탠바이미 구매 vs 렌탈 고민,구매 고려 및 비교,0,0,1,1
스탠바이미 구독 계획,렌탈 및 구독 서비스,0,0,1,1
스탠바이미 구독,제품 선택 및 구매,0,0,1,1
스탠바이미 교환 가능,기타,0,0,1,1
스탠바이미 광고 화제,제품 사용 경험 및 평가,0,0,1,1
스탠바이미 광고 기대,기타,1,0,0,1
스탠바이미 광고 관심,광고 및 홍보,0,0,1,1
스탠바이미 광고,기타,0,0,1,1
스탠바이미 고와 나들이,캠핑 및 야외 활동,1,0,0,1
스탠바이미 TV 관심,기타,0,0,1,1
스탠바이미 고민,스탠바이미 제품 및 기능,0,0,1,1
스탠바이미 고 휴대,기타,0,0,1,1
스탠바이미 고 홍보,제품 홍보 및 출시 기대,0,0,1,1
스탠바이미 고 할인,기타,1,0,0,1
스탠바이미 고 한정판 출시,프로모션 및 이벤트,0,0,1,1
스탠바이미 고 필요성 없음,기타,0,0,1,1
스탠바이미 고 판매,제품 특징 및 기능,0,0,1,1
스탠바이미 고 티비 소유,기타,0,0,1,1
스탠바이미 고 캠핑용,제품 및 가격 정보,0,0,1,1
스탠바이미 구매 관심,기타,0,0,1,1
스탠바이미 구매 또는 렌탈 고민,기타,0,0,1,1
스탠바이미 구매 시도,기타,0,0,1,1
스탠바이미 구매 우선순위 낮음,제품 선택 및 구매,0,0,1,1
스탠바이미 대체 가능,스탠바이미 제품,0,0,1,1
스탠바이미 대여,교육 및 특별 용도,0,0,1,1
스탠바이미 단점 보완,제품 사용 경험 및 평가,1,0,0,1
스탠바이미 노래,영화 및 문화,0,0,1,1
스탠바이미 네이밍,부가 기능 및 기타,0,0,1,1
스탠바이미 넘어질 우려,사용 및 설치 환경,0,1,0,1
스탠바이미 깔끔한 디자인,제품 기능 및 성능,0,0,1,1
스탠바이미 기회,기타,1,0,0,1
스탠바이미 기존 사용자,제품 구매 및 만족도,0,0,1,1
스탠바이미 기능 동일,제품 기능 및 성능,0,0,1,1
스탠바이미 기능 궁금증,기타,0,0,1,1
스탠바이미 기능 관심,제품 사용 및 기능,0,0,1,1
스탠바이미 기능,제품 기능 및 사용성,0,0,1,1
스탠바이미 금액 부담,스탠바이미 제품 및 기능,0,1,0,1
스탠바이미 구입 고민,기타,0,0,1,1
스탠바이미 구입,기타,0,0,1,1
스탠바이미 구매 혜택,제품 기대 및 스펙,0,0,1,1
스탠바이미 구매 추천,제품 사용 경험 및 평가,0,0,1,1
스탠바이미 구매 증가,구매 및 소비,0,0,1,1
스탠바이미 고 첫 사용 만족,제품 특징 및 사용,1,0,0,1
스탠바이미 고 제품 홍보,제품 만족도 및 홍보,0,0,1,1
스탠바이미 고 제품 정보,기타,0,0,1,1
스탠바이미 가격 할인,스탠바이미 제품,1,0,0,1
스탠바이미 가격 및 스펙 정보,기타,0,0,1,1
스탠바이미 가격 문의,스탠바이미 관련,0,0,1,1
스탠바이미 vs 스마트모니터 vs TV 고민,구매 및 선택 고민,0,0,1,1
스탠바이미 vs 삼텐바이미 비교,기타,0,0,1,1
스탠바이미 vs 삼탠바이미 선택 고민,제품 비교 및 선택 고민,0,0,1,1
스탠바이미 go 챔피언에디션,제품 특징 및 사용,0,0,1,1
스탠바이미 go 선호,기타,1,0,0,1
스탠바이미 UHD,제품 기능 및 성능,0,0,1,1
스탠바이미 TV와 결합 가능,기타,0,0,1,1
스탠바이미 TV 한정수량 판매,스탠바이미 제품 관련,0,0,1,1
스탠바이미 TV 출시,신제품 및 모델,0,0,1,1
스탠바이미 TV 정보,제품 정보 및 출시,0,0,1,1
스탠바이미 TV 소형 가전,제품 특징 및 비교,1,0,0,1
스탠바이미 TV 소개,기타,0,0,1,1
스탠바이미 TV 리뷰,기능 및 사용,0,0,1,1
스탠바이미 TV 기능,제품 정보 및 추천,0,0,1,1
스탠바이미 TV 긍정적 인상,사용자 경험 및 만족도,1,0,0,1
스탠바이미 TV 구매처,제품 정보 및 추천,0,0,1,1
스탠바이미 TV 구매,스탠바이미 관련,0,0,1,1
스탠바이미 가격 아쉬움,스탠바이미 제품,0,1,0,1
스탠바이미 가족,브랜드 및 홍보,0,0,1,1
스탠바이미 고 안내,기타,0,0,1,1
스탠바이미 감성,제품 정보 및 추천,0,0,1,1
스탠바이미 고 신상품,기타,0,0,1,1
스탠바이미 고 선택 가능,신제품 및 출시 소식,0,0,1,1
스탠바이미 고 선물,렌탈 및 구매 옵션,0,0,1,1
스탠바이미 고 사은품,제품 비교 및 기타,0,0,1,1
스탠바이미 고 사용,캠핑 및 야외 활동,0,0,1,1
스탠바이미 고 모델 출시,신제품 및 출시 소식,0,0,1,1
스탠바이미 고 론칭,제품 출시 및 홍보,0,0,1,1
스탠바이미 고 기종,기타,0,0,1,1
스탠바이미 고 기대,제품 인기 및 추천,1,0,0,1
스탠바이미 고 구매 고려,기타,0,0,1,1
스탠바이미 고 구매,기타,0,0,1,1
스탠바이미 고 검색,제품 기능 및 성능,0,0,1,1
스탠바이미 고 가격 포함,제품 출시 및 이벤트,0,0,1,1
007가방 사용,기타,0,0,1,1
스탠바이미 경품 추첨,제품 판매 및 혜택,0,0,1,1
스탠바이미 경품 인기,제품 추천 및 체험,1,0,0,1
스탠바이미 경품 이벤트,제품 추천 및 체험,0,0,1,1
스탠바이미 경추베개 사용,기타,0,0,1,1
스탠바이미 경쟁 제품,기타,0,0,1,1
삼성 모니터와 거치대 조립,제품 비교 및 구매 고려,0,0,1,1
삼성 더프리스타일,기타,0,0,1,1
듀얼스피커,기능 및 성능,1,0,0,1
모바일 기기 화면 미러링 가능,사용자 경험 및 기능,1,0,0,1
모바일 방치형 게임과 다름,문화 및 엔터테인먼트,1,0,0,1
모바일 미러링 지원,제품 특성 및 기능,0,0,1,1
모바일 미러링,제품 활용 및 기능,1,0,0,1
모바일 리모컨,제품 기능 및 연결성,0,0,1,1
모바일 디바이스 노하우 활용,사용자 편의 및 기능,0,0,1,1
모바일 기프티콘 사용,기타,0,0,1,1
모바일 기기처럼 활용 가능,사용자 편의성 및 이동성,1,0,0,1
모바일 기기처럼 사용 가능,제품 특성 및 기능,1,0,0,1
모바일 기기와 화면 공유,기능 및 사용성,0,0,1,1
모바일 기기 재생 가능,제품 스펙 및 기능,1,0,0,1
모바일 거치대 부착 위치 권장,기타,0,0,1,1
모바일 기기 자동 연결,기타,1,0,0,1
모바일 기기 사양에 따른 차이,기타,0,0,1,1
모바일 기기,기술 및 호환성,0,0,1,1
모바일 구매 혜택,프로모션 및 이벤트,0,0,1,1
모바일 공유로 수업 가능,기타,1,0,0,1
모바일 게임과 차별화,기타,1,0,0,1
모바일 거치대 제거,기타,0,0,1,1
모바일 거치대 유무,기타,0,0,1,1
모바일 거치대 설명서 포함,제품 디자인 및 조립,0,0,1,1
모바일 사진 업로드,기타,1,0,0,1
모바일 생방송 판매 서비스,이벤트 및 프로모션,0,0,1,1
모바일 쇼핑 시간 소요,기타,0,1,0,1
모바일 실패 후 성공 기대,기타,0,0,1,1
모바일 확인서비스 사용 제한,기술 및 기능,0,0,1,1
모바일 화면공유 기능,제품 활용 및 기능,1,0,0,1
모바일 화면 즐김,기타,0,0,1,1
모바일 화면 공유 지원,기능 및 사용 편의성,1,0,0,1
모바일 화면 공유 기능,편의성과 활용,0,0,1,1
모바일 핫스팟,기능 및 성능,0,0,1,1
모바일 프로젝터,제품 및 모델 비교,0,0,1,1
모바일 폰 크래들 호환,기타,1,0,0,1
모바일 폰 미러링 간편,기능 및 호환성,1,0,0,1
모바일 폰 미러링 가능,기능 및 사용 편의성,1,0,0,1
모바일 클립으로 휴대폰 거치,기타,1,0,0,1
모바일 클립,기타,1,0,0,1
모바일 크래들 제공,기타,1,0,0,1
모바일 쿠폰 지급,추가 서비스 및 경품,1,0,0,1
모바일 주유쿠폰 및 LG 스탠바이미GO 획득 기회,가격 및 프로모션,0,0,1,1
모바일 웹 사용,기타,0,0,1,1
모바일 연결,제품 기능 및 사용성,1,0,0,1
모바일 앱으로 주유 가능,기타,0,0,1,1
모바일 앱 서비스,기타,0,0,1,1
모바일 거치대 사라짐,사용자 불만 및 문제점,0,0,1,1
모바일 거치대 미장입,디자인 및 혁신,0,0,1,1
물량 부족,구매 및 할인,0,0,1,1
면역력 강화,기타,1,0,0,1
모니터 상태 양호,제품 상태 및 가격,1,0,0,1
모니터 사이즈 27인치,기타,0,0,1,1
모니터 사용 고민,기타,0,0,1,1
모니터 모드,다양한 기능 및 설정,1,0,0,1
모니터 거치대 판매,기타,0,0,1,1
명작 할머니의 추억 재구축,기타,0,0,1,1
명상 영상 시청,고객 경험 및 만족도,1,0,0,1
명륜진사갈비 이용권,기타,0,0,1,1
명륜진사갈비 방문기,기타,0,0,1,1
멤버십 패키지,기타,0,0,1,1
모바일 거치대 기본제공,제품 특성 및 기능,0,0,1,1
멤버십 첫 가입 혜택,이벤트 및 혜택,0,0,1,1
멤버십 가입 필요,부가 서비스 및 혜택,0,0,1,1
멤버십 BOARDING 패키지 경품,이벤트 및 혜택,0,0,1,1
메인 티비로 사용 가능성,제품 특징 및 사용성,0,0,1,1
메모리폼 소재,기타,0,0,1,1
메가스토어,마케팅 및 판매,0,0,1,1
멋진 디자인,디자인 및 품질,1,0,0,1
멋진 감성 공간,디자인 및 인테리어,1,0,0,1
멋있고 훌륭한 디자인,디자인 및 공간 활용,1,0,0,1
모니터 상하좌우 이동 가능,제품 기능 및 사용성,1,0,0,1
모니터 손상,사용 빈도 및 문제,0,1,0,1
모니터 연결 편리,기능 및 사용 편의성,0,0,1,1
모니터 이동 불편,제품 설치 및 이동 문제,0,1,0,1
모바일 NFC 지원,제품 및 기술 사양,1,0,0,1
모바일 MMORPG에서 발라드 여가수 목소리,기타,0,0,1,1
모르는 번호로 전화,기타 이슈 및 요구,0,0,1,1
모두의마블 가능,기타,0,0,1,1
모두 즐겁게 참여,참여 및 체험,1,0,0,1
모델별 차이,기타,0,0,1,1
모델명 27ART10DQPL,기타,0,0,1,1
모델 차이 이해 부족,사용 경험 및 후기,0,0,1,1
모델 종류,기타,0,0,1,1
모델 선택,제품 구매 및 기대,0,0,1,1
모델 비교,제품 비교 및 추천,0,0,1,1
모델 대체 출고,제품 및 기술 사양,0,0,1,1
모던한 홈 엔터테인먼트,기타,0,0,1,1
모던한 디자인,디자인 및 공간 활용,1,0,0,1
모닥불 불멍 느낌,기타,1,0,0,1
모니터 해상도 아쉬움,성능 아쉬움,0,1,0,1
모니터 크기 선택 가능,디자인 및 크기,1,0,0,1
모니터 크기 고민,기타,0,0,1,1
모니터 있음,기타,0,0,1,1
모바일 환경 적합,편의성과 활용,0,0,1,1
모바일게임 컨트롤,기타,0,0,1,1
모바일폰으로 유튜브 시청,기타,0,0,1,1
무선 넷플릭스 시청,제품 활용 및 기능,1,0,0,1
무선 연결 지원,기타,1,0,0,1
무선 스피커,제품 특성 및 기능,0,0,1,1
무선 스탠드형,스탠바이미 제품,0,0,1,1
무선 스크린,제품 기능 및 연결성,0,0,1,1
무선 소형 TV,이동성과 휴대성,0,0,1,1
무선 사용,제품 및 기능 만족,1,0,0,1
무선 미니청소기,제품 기능 및 사용성,0,0,1,1
무선 무빙 스탠드 스크린,이동식 스마트 TV,0,0,1,1
무선 디자인,이동 및 휴대성,1,0,0,1
무선 가능 여부,사용 편의성 및 기능,0,0,1,1
모터홈,사용 용도 및 환경,0,0,1,1
무선,기능 및 기술,1,0,0,1
무상 제공,학습 및 콘텐츠,0,0,1,1
무상 AS 보장,고객 서비스 및 지원,1,0,0,1
무상 A/S 제공,기타,1,0,0,1
무상 A/S 5년,서비스 및 지원,1,0,0,1
무빙휠로 자유로운 이동,이동 및 사용 편의성,1,0,0,1
무빙휠 탑재,제품 디자인 및 조립,0,0,1,1
무빙휠 장착,이동 및 설치 용이성,1,0,0,1
무빙휠 스탠드,기타,0,0,1,1
무선 이동 가능,제품 기능 및 사용성,1,0,0,1
무선 이동성,기능 및 성능,1,0,0,1
무선 이동식 스마트TV,캠핑 및 휴대성,0,0,1,1
무선 재생 가능,기능 및 사용 편의성,1,0,0,1
문제 해결,기타,1,0,0,1
문제 있는 부분,제품 불만 및 문제,0,1,0,1
문제 없음,기타,1,0,0,1
문자 메시지 정크 저장,기타 이슈 및 요구,0,1,0,1
문의 권장,기타,0,0,1,1
묶음할인으로 저렴하게 구매,구매 및 거래,1,0,0,1
무타공 설치,기타,1,0,0,1
무이자 24개월,가격 및 결제,1,0,0,1
무용지물,기타,0,1,0,1
무신산타 이벤트,마케팅 및 프로모션,0,0,1,1
무선충전,제품 특성 및 기능,1,0,0,1
무선/유선 가능,제품 기능 및 사용성,0,0,1,1
무선 활용,기능 및 기술,1,0,0,1
무선 프라이빗 스크린,기타,0,0,1,1
무선 편리,기타,1,0,0,1
무선 티비로 활용 가능,기타,0,0,1,1
무선 제품,제품 기능 및 성능,1,0,0,1
무선 재생시간,기능 및 성능,1,0,0,1
무선 재생 시간,기술 및 기능,0,0,1,1
무빙휠 미적용,제품 이동성 및 설치,0,1,0,1
무빙휠 달린 스탠딩 거치대,기타,0,0,1,1
무빙휠,제품 디자인 및 조립,0,0,1,1
무드등,제품 특성 및 기능,1,0,0,1
무기스,제품 상태 및 거래,1,0,0,1
무광 화면,기타,1,0,0,1
무게감 있음,기타,0,0,1,1
무게 제외 모든 것 장점,사용자 경험,1,0,0,1
무게 단점,사용자 경험,0,1,0,1
무겁지만 이동 가능,부가 정보 및 기타,0,0,1,1
무겁다,기타,0,1,0,1
무겁고 큼,사용 경험 및 평가,0,1,0,1
무거운 스탠드,기타,0,1,0,1
묘한 매력,기타,1,0,0,1
몸 상태 불편,사용 편의성 및 편리함,0,1,0,1
몰입적인 엔터테인먼트,제품 정보 및 추천,1,0,0,1
몰입적인 경험,디자인 및 기능,0,0,1,1
목표 달성,기타,0,0,1,1
목주름 방지,기타,1,0,0,1
목의 피로,사용자 경험 및 만족도,0,1,0,1
목디스크에 좋음,기타,1,0,0,1
목과 어깨 통증 완화,편안함 및 건강,0,0,1,1
모토캠핑에 사이즈 부담,활용 및 용도,0,1,0,1
무드 조성,기타,1,0,0,1
무료 배송 및 설치,사용 및 설치,1,0,0,1
무빙큐빅스 스마트 24인치 스탠바이미,제품 및 기술 사양,0,0,1,1
무료 상담 신청,구매 및 사용 경험,0,0,1,1
무빙스탠드 지원 확대,이동성과 휴대성,0,0,1,1
무빙스탠드 가격,구매 및 가격 혜택,0,0,1,1
무빙스탠드,편의 및 이동성,0,0,1,1
무빙 휠로 자유로운 이동,이동 및 캠핑 활용,1,0,0,1
무빙 휠 연결,사용자 편의성 및 이동성,0,0,1,1
무빙 휠,제품 이동성 및 설치,0,0,1,1
무빙 스탠드 가격,가격 및 구매,0,0,1,1
무빙 스탠드,제품 디자인 및 이동성,0,0,1,1
무료 테마 제공,엔터테인먼트 및 콘텐츠,1,0,0,1
무료 체험 서비스,프로모션 및 혜택,1,0,0,1
무료 체험 가능,구매 및 가격 혜택,0,0,1,1
무료 증정 이벤트,이벤트 및 혜택,1,0,0,1
무료 증정 기회,제품 추천 및 체험,1,0,0,1
무료 인수형 렌탈 가능,이벤트 및 프로모션,0,0,1,1
무료 이용,기타,1,0,0,1
무료 이벤트 정보,이벤트 및 프로모션,0,0,1,1
무료 이벤트,이벤트 및 혜택,0,0,1,1
무료 업데이트,추가 기능 및 혜택,1,0,0,1
무료 아님,기타,0,1,0,1
멋스러움,디자인 및 인테리어,1,0,0,1
멀티화면 이용,활용 및 용도,1,0,0,1
멀티탭과 아답터 불필요,기능 및 호환성,1,0,0,1
렌탈 견적 비교,가격 및 구매,0,0,1,1
렌탈 선호,구매 및 판매 정보,0,0,1,1
렌탈 서비스 선호,가격 및 경제성,0,0,1,1
렌탈 서비스,가격 및 렌탈,0,0,1,1
렌탈 비용,가격 및 혜택,0,0,1,1
렌탈 발견,기타,0,0,1,1
렌탈 및 구독 옵션,가격 및 구매,0,0,1,1
렌탈 구매 추천,이벤트 및 프로모션,0,0,1,1
렌탈 구매 가능,이벤트 및 혜택,0,0,1,1
렌탈 계약 가능,구매 및 이벤트,1,0,0,1
렌탈 가능 여부 문의,구매 및 판매 정보,0,0,1,1
룸앤티비2세대 구매 고민,제품 특성 및 용도,0,0,1,1
렌탈 가격 비교,구매 및 이벤트,0,0,1,1
레이턴시 감소,기타,1,0,0,1
레시피 찾기에 유용,구매 및 사용 경험,1,0,0,1
레디백 디자인,디자인 및 품질,0,0,1,1
레디백,기타,0,0,1,1
레디 투 고 레디 투 유스,제품 모델 및 출시,0,0,1,1
러트 사용 가능,개인 사정 및 기타,1,0,0,1
랜덤 휘슬 포인트,참여 및 이벤트,0,0,1,1
라이프스타일 제품 선도,기타,1,0,0,1
렌탈 신청 가능,기타,0,0,1,1
렌탈 임대 대여,가격 및 경제성,0,0,1,1
렌탈 핫딜,기타,0,0,1,1
렌탈 현금지원 문의,기타,0,0,1,1
룸앤티비 비교,제품 비교 및 평가,0,0,1,1
룸앤티비 보유,기타,0,0,1,1
룸앤티비 반응 느림,제품 불만 및 문제,0,1,0,1
룸앤티비 대안,기타,0,0,1,1
룸앤티비 거치대 필요,제품 비교 및 평가,0,0,1,1
룸앤티비 2세대 방출,제품 비교 및 평가,0,0,1,1
룸앤티비 1세대 사용,기타 제품 및 서비스,0,0,1,1
룸앤티비 1세대 반응속도 느림,제품 비교 및 평가,0,1,0,1
룸앤스타일 리뷰 적음,고객 만족 및 리뷰,0,0,1,1
루프백 준비,이동 및 휴대성,0,0,1,1
루메나 탁상용 세일,기타,0,0,1,1
롱릴렉스체어 부피 문제,부가 기능 및 기타,0,1,0,1
롯데월드몰 전시,기타,0,0,1,1
롭 라이너 감독,영화 및 문화,0,0,1,1
로켓배송 없음,구매 및 배송,0,1,0,1
로브 라이너 감독,영화 및 문화,0,0,1,1
로드샵 미판매,사회적 이슈 및 트렌드,0,0,1,1
렌탈할부 저렴,기타,1,0,0,1
렌탈 혜택,구매 및 판매 정보,1,0,0,1
라이프스타일 다양성,사용자 경험 및 만족도,1,0,0,1
라이브커머스 판매,시장 및 소비자 반응,0,0,1,1
라이브 특가,제품 구매 및 경제성,0,0,1,1
디자인 차이,디자인 및 외관,0,0,1,1
디자인 및 성능 평가,제품 및 기술 사양,0,0,1,1
디자인 구경,기타,0,0,1,1
디자인 개선,문제 및 개선점,1,0,0,1
디자이너 칭찬,디자인 및 인테리어,1,0,0,1
디스플레이와 배터리 조합,기타,0,0,1,1
디스플레이 터치 상태 좋음,제품 상태 및 문제,1,0,0,1
디스플레이 세로 회전 가능,기능 및 기술,0,0,1,1
디스플레이 돌아가는 엘지윙,제품 기능 및 성능,0,0,1,1
디스플레이 노출 최적화,기타,1,0,0,1
디바이스와 콘텐츠 결합,기타,0,0,1,1
디바이스 호환 가능,기능 및 호환성,1,0,0,1
디바이스 연결 활용성,기능 및 기술,1,0,0,1
들고 다니는 스크린 TV,기타,0,0,1,1
듣기 좋은 음악,기타,1,0,0,1
득템 소식,기타,1,0,0,1
득템 기대,구매 및 이벤트,1,0,0,1
드라마 출연 후 인기 상승,광고 및 마케팅,0,0,1,1
드라마 시청 만족,기타,1,0,0,1
듀얼와이파이,기능 및 성능,1,0,0,1
디자인 아쉬움,기타,0,1,0,1
디자인에 대한 긍정적 인식,디자인 및 공간 활용,1,0,0,1
라이브 방송 보기 어려움,사용자 경험 및 리뷰,0,1,0,1
디즈니+ 미러링 필요,기능 및 기술,0,1,0,1
라이브 모델 구매 인증 이벤트,이벤트 및 프로모션,0,0,1,1
뜻밖의 인기,제품 출시 및 리뷰,1,0,0,1
뛰어난 화면 색상,제품 기능 및 성능,1,0,0,1
뛰어난 특징,제품 특징 및 기능,1,0,0,1
뛰어난 스펙,기술 및 성능,1,0,0,1
뛰어난 보안 기능,보안 및 안전,1,0,0,1
뛰어난 내구성,제품 내구성 및 품질,1,0,0,1
뛰어난 내구도,제품 내구성 및 성능,1,0,0,1
뛰어난 기능성,제품 특성 및 기능,1,0,0,1
딸의 만족,제품 디자인 및 만족도,1,0,0,1
딱딱하고 큰 알갱이,기타,0,0,1,1
따뜻한 스탠드 조명,디자인 및 인테리어,1,0,0,1
딜레이 문제,기타,0,1,0,1
디피 상품 구매,거래 및 구매,0,0,1,1
디터람스 디자인 카피 의혹,디자인 및 인테리어,0,1,0,1
디지털 아트워크 제공,기타,0,0,1,1
디지털 불멍 제공,사용 환경 및 활용,1,0,0,1
디지털 라이프스타일에 적합,제품 특징 및 사용성,1,0,0,1
디즈니+ 실행 불가,기타,0,1,0,1
룸앤티비 스탠바이미 3세대,기타,0,0,1,1
룸앤티비에서 기변 문의,기타,0,0,1,1
멀티탭 거치 가능,제품 특성 및 기능,1,0,0,1
마케팅 의혹,판매 및 마케팅,0,0,1,1
만족스러운 크기,화질 및 화면,1,0,0,1
만족스러운 스피커,제품 기능 및 성능,1,0,0,1
만족스러운 스탠바이미,스탠바이미 제품 및 기능,1,0,0,1
만족스러운 사운드,제품 특징 및 사용,1,0,0,1
만족스러운 구매,제품 디자인 및 만족도,1,0,0,1
만족도 질문,기타,0,0,1,1
만족 가능성,기타,1,0,0,1
만족,고객 만족 및 리뷰,1,0,0,1
막국수 식사,기타,0,0,1,1
마지막 장면 의미,영화 및 문화,0,0,1,1
룸앤티비와 비교,제품 비교 및 평가,0,0,1,1
마지막 관람일 2021년 3월 3일,기타,0,0,1,1
마이뷰 모드,기타,1,0,0,1
마음의 정화,마음의 만족,1,0,0,1
마음에 드는 스크린,제품 디자인 및 만족도,1,0,0,1
마음에 드는 부분,제품 만족도 및 홍보,1,0,0,1
마운트피크가방 포함,부가 정보 및 기타,0,0,1,1
마운트와 스탠드,구성 및 설치,0,0,1,1
마우스 느림,기능 및 성능,0,1,0,1
마샬스피커 대체,음향 및 스피커,1,0,0,1
많은 관심과 신청,추천 및 계획,1,0,0,1
많은 당첨자 수,이벤트 및 혜택,1,0,0,1
많은 사람들 사용,사용 사례 및 추천,1,0,0,1
많은 사람들의 관심,기타,0,0,1,1
멀티캠,기능 및 호환성,0,0,1,1
멀티미디어 스피커 활용,기술 및 호환성,0,0,1,1
멀티미디어 솔루션,제품 평가 및 후기,1,0,0,1
멀티미디어 경험,멀티미디어 기능,1,0,0,1
맥주,기타,0,0,1,1
맥시멀리스트 라이프스타일,기타,0,0,1,1
맥세이프 스타일,제품 크기 및 디자인,1,0,0,1
매트한 질감,디자인 및 외관,0,0,1,1
매장 전시 계획,제품 출시 및 홍보,0,0,1,1
매장 상담 예약,가격 및 구매,0,0,1,1
매장 방문 불편,문제 및 개선점,0,1,0,1
매일 사용,사용 사례 및 추천,1,0,0,1
매립형 멀티탭 정리,기타,0,0,1,1
매력적,사용자 경험 및 만족도,1,0,0,1
매니저 감사,긍정적 평가,1,0,0,1
매뉴얼 정독 부족,기타,0,0,1,1
매뉴얼 미숙지로 인한 실수,부가 정보 및 기타,0,1,0,1
맞춤형 테이블,디자인 및 공간 활용,1,0,0,1
맞교환 가능,사용자 경험,0,0,1,1
마샤와 스탠의 관계 중심,문화 및 엔터테인먼트,0,0,1,1
링크 포함,기타,0,0,1,1
링크 클릭 위험,기타,0,1,0,1
리모컨 불 없음,제품 기능 및 사용성,0,1,0,1
리모컨 보관 편리,제품 기능 및 사용성,1,0,0,1
리모컨 배터리 필요,사용자 경험,0,0,1,1
리모컨 및 충전기 포함,기타,0,0,1,1
리모컨 및 충전 선 보관 가능,제품 호환 및 액세서리,0,0,1,1
리모컨 및 충전 선 보관,제품 특성 및 디자인,0,0,1,1
리모컨 문구 지워짐,제품 상태 및 신뢰성,0,1,0,1
리모컨 동일,기술 및 기능,0,0,1,1
리모컨 구입 가능,기타,0,0,1,1
리모컨 구매 가능,제품 개선 및 아쉬움,0,0,1,1
리모컨 건전지 동봉,제품 기능 및 연결성,1,0,0,1
리모컨 거치대,제품 및 액세서리,0,0,1,1
리모컨 개선품 아쉬움,제품 개선 및 아쉬움,0,1,0,1
리딩앤 어플 설치 가능 여부,기타,0,0,1,1
리딩앤 어플 설치,기타,0,0,1,1
류현진 선수와의 연관성,기타,0,0,1,1
룸투룸셰어 기능,기타,1,0,0,1
룸투룸 셰어 기능,제품 디자인 및 기능,0,0,1,1
룸엔티비 무게,기타,0,0,1,1
룸엔TV와 스탠바이미 결합,기타,1,0,0,1
리모컨 부착 권장,기타,0,0,1,1
리모컨 사용,기술 및 기능,1,0,0,1
링크 제공,기타,0,0,1,1
리모컨 사용 가능,사용 편의성,1,0,0,1
링크 요청,기타,0,0,1,1
릴선 위치로 이동 불편,사용 용도 및 환경,0,1,0,1
리셀 가능성,제품 구매 및 결정,1,0,0,1
리브메이트 퀴즈,기타,0,0,1,1
리뷰어 신청 기간,구매 및 이벤트,0,0,1,1
리뷰 작성 포인트 적립,이벤트 및 프로모션,0,0,1,1
리뷰 개수 많음,기타,0,0,1,1
리뷰 138개,기타,0,0,1,1
리뷰,사용자 경험 및 만족도,0,0,1,1
"리버 피닉스, 윌 휘튼, 제리 오코넬, 코리 펠드만 주연",기타,0,0,1,1
리버 피닉스 출연,영화 및 문화,0,0,1,1
리버 피닉스,기타,0,0,1,1
리모콘 충전기 포함,설치 및 사용 불편,0,0,1,1
리모콘 사용 필요,기능 및 사용성,0,1,0,1
리모콘,제품 기능 및 사용성,0,0,1,1
리모컨 편리,기타,1,0,0,1
리모컨 작동 가능,사용 용도 및 기능,1,0,0,1
리모컨 없이 활용 가능,사용자 편의 및 기능,1,0,0,1
리모컨 사용 편리,사용 용도 및 기능,1,0,0,1
문학가의 꿈,영화 관련,0,0,1,1
물량 증가,기타,0,0,1,1
삼성 TV모니터 호환,제품 기능 및 사용성,0,0,1,1
블루투스 연결 가능,제품 기능 및 연결성,1,0,0,1
비스포크 사이드 테이블 관심,기타,0,0,1,1
비밀 구매로 인한 갈등,기타,0,1,0,1
비대면 학습,참여 및 체험,0,0,1,1
비대면 선호 MZ세대,소비자 반응,1,0,0,1
비대면 결제 가능,구매 및 배송,1,0,0,1
비교 예정,기타,0,0,1,1
비교,기타,0,0,1,1
블루투스 페어링,제품 성능 및 기능,1,0,0,1
블루투스 연결 용이,제품 기능 및 성능,1,0,0,1
블루투스 스피커 사용,기타,0,0,1,1
블랙 스탠드형,기타,0,0,1,1
블루투스 스피커 모드,다양한 기능 및 설정,0,0,1,1
블루투스 스피커 동글 필요,기능 및 연결성,0,1,0,1
블루투스 스피커 기능,기술 및 기능,1,0,0,1
블루투스 스피커,제품 및 모델 비교,0,0,1,1
블루투스 기능,연결 및 호환성,0,0,1,1
블루투스,제품 기능 및 디자인,0,0,1,1
블루원리조트,기타,0,0,1,1
블루라이트 차단 기능,제품 기능 및 성능,1,0,0,1
블로그 포스팅 정직성 의문,사용 후기 및 신뢰,0,1,0,1
비싼 가격 예상,기타,0,1,0,1
비싼 기기 포함 영어 프로그램 피해야 함,가격 및 구매 고려,0,1,0,1
비싼 영어 프로그램 피해야 함,기타,0,1,0,1
비쌈,가격 및 구매,0,1,0,1
빙고 스탬프 투어,이벤트 및 프로모션,0,0,1,1
빙고 스탬프 체험,이벤트 및 참여,1,0,0,1
빔프로젝트 한계 극복,사용자 경험 및 기능,1,0,0,1
빔프로젝트 판매 예정,기타,0,0,1,1
빔프로젝트 보유,기타,0,0,1,1
빔프로젝트 대안으로 구매,구매 고려 및 비교,0,0,1,1
빔프로젝트 vs 스탠바이미 선택 고민,제품 비교 및 선택 고민,0,0,1,1
빔프로젝터와 비교,기타,0,0,1,1
빔프로젝터 엑스지미 헤일로 비교,제품 비교 및 평가,0,0,1,1
빔프로젝터 사용,기타,0,0,1,1
빔프로젝터 대체,제품 기능 및 성능,1,0,0,1
빔 프로젝터와 비교,기타,0,0,1,1
빅 이벤트,기타,1,0,0,1
비행기 화물로 스피커 운반 가능 여부 질문,기타,0,0,1,1
비트버그 실시간 뉴스 제공,기타,0,0,1,1
비용 절약,가격 및 렌탈,1,0,0,1
비용 절감 대안,가격 및 경제성,1,0,0,1
비용 부담 없음,기타,1,0,0,1
비용 부담,기타,0,1,0,1
블로그 포스팅 시 활용,기타,1,0,0,1
브랜드/모델명 정보,제품 특성 및 기능,0,0,1,1
물품 상태 양호,제품 상태 및 거래 조건,1,0,0,1
부속품 충전선,부속품 및 추가 기능,0,0,1,1
분위기 연출,기타,1,0,0,1
분위기 개선,기타,1,0,0,1
북미 인기,브랜드 및 유명세,1,0,0,1
북미 및 유럽 출시,제품 및 브랜드 인식,0,0,1,1
"부피, 무게, 금액 고민",제품 불만 및 문제,0,0,1,1
부피 차지,기타,0,1,0,1
부피 문제,제품 특징 및 사용,0,1,0,1
부천동 거래 희망,가격 및 거래,0,0,1,1
부유한 백인들,기타,0,0,1,1
부산 위치,거래 및 배송,0,0,1,1
브랜드 홍보,브랜드 및 홍보,0,0,1,1
부산 및 인근지역 거래 가능,거래 및 가격,0,0,1,1
부산 및 인근 지역 거래 가능,거래 및 판매 관련,0,0,1,1
부모님 선물,기타,1,0,0,1
부드러운 화면,화질 및 화면,1,0,0,1
부드러운 물맛,기타,1,0,0,1
부동산 정보 사칭,기타,0,1,0,1
본품 없음,제품 상태 및 사용,0,0,1,1
본사 사후 관리,서비스 및 지원,1,0,0,1
본격적 판매 시작,기타,0,0,1,1
분위기 좋은 뮤직바,기타 기능 및 특징,1,0,0,1
분위기 좋은 서촌 데이트 코스,디자인 및 스타일,1,0,0,1
분위기 좋은 와인,기타,1,0,0,1
분위기 좋은 와인바,기타,1,0,0,1
브랜드 인지도,시장 반응 및 인기,0,0,1,1
브랜드 및 모델명 언급,브랜드 및 모델,0,0,1,1
브랜드 및 모델 비교,구매 및 이벤트,0,0,1,1
브랜드 LG,브랜드 및 유명세,0,0,1,1
브랜드,기타,0,0,1,1
브라이덜 샤워 스튜디오 설정,활용 및 용도,1,0,0,1
불필요한 제품,기타,0,1,0,1
불필요한 사은품 판매,구매 및 거래,0,0,1,1
불필요한 TV,개인 사정 및 기타,0,1,0,1
불친절한 응대,문제 및 불만,0,1,0,1
불안정함 우려,사용자 경험,0,1,0,1
불멍모니터,기타,0,0,1,1
불멍 세팅,기타,1,0,0,1
불멍 및 독서,기타,1,0,0,1
불멍 대체,사용 환경 및 목적,1,0,0,1
불멍 가능,제품 특성 및 용도,1,0,0,1
불량/사기회원 신고,기타,0,1,0,1
분위기 향상,기타,1,0,0,1
분위기 좋은 장소,장소 및 분위기,1,0,0,1
빙고 이벤트,이벤트 및 혜택,0,0,1,1
빠른 거래,기타,0,0,1,1
빠른 구매 결정,결제 및 구매 관련,0,0,1,1
사운드 최적화,제품 내구성 및 성능,1,0,0,1
사전 예약 혜택,구매 및 가격 혜택,0,0,1,1
사장님의 취향,기타,0,0,1,1
사이즈 정보,기타,0,0,1,1
사이즈 부담,기타,0,1,0,1
사이즈 및 무게 정보 제공,제품 선택 및 구매,0,0,1,1
사이드메뉴,기타,0,0,1,1
사은품 포함,부가 정보 및 기타,1,0,0,1
사은품 이벤트,이벤트 및 프로모션,0,0,1,1
사운드바 연결 간편,제품 기능 및 성능,1,0,0,1
사운드 만족,기능 및 연결성,1,0,0,1
빠른 구매 권장,구매 및 이벤트,0,0,1,1
사운드 10W/2.0ch,기타,0,0,1,1
사운드,기능 및 성능,0,0,1,1
사용할 일이 없음,제품 특징 및 활용,0,0,1,1
사용하기 좋음,사용 편의성,1,0,0,1
사용자 피드백 반영,제품 특성 및 기능,0,0,1,1
사용자 편의성,사용자 편의성 및 이동성,1,0,0,1
사용자 편의,다양한 기능 및 설정,0,0,1,1
사용자 친화적인 기능,편리한 조작 및 사용자 경험,1,0,0,1
사용자 참여,기타,0,0,1,1
사전구매 놓침,기타,0,1,0,1
사전예약 가능,구매 과정,0,0,1,1
사전예약 구매,가격 및 구매,0,0,1,1
사전예약 이벤트,판매 및 마케팅,0,0,1,1
삼성 M7 비교,제품 비교,0,0,1,1
삼성 M5 M7 호환,기능 및 호환성,0,0,1,1
삼성 M5 M7 M8 비교,기타,0,0,1,1
삼성 M5 M7 M8 모델,브랜드 및 모델,0,0,1,1
삼성 LG 호환,기타,0,0,1,1
삼성 LED TV,기타,0,0,1,1
삶의 활력,사용자 경험,1,0,0,1
삶의 질 향상 기대,특정 상황 및 용도,0,0,1,1
삶의 질 상승,기타,1,0,0,1
삶의 업그레이드,사용 후기 및 경험,1,0,0,1
산책 시 사용,사용 및 기능,0,0,1,1
사태의 심각성,기타,0,1,0,1
사진 촬영 어려움,기타,0,1,0,1
사진 촬영,기타 이슈 및 요구,0,0,1,1
사진 참여,기타,0,0,1,1
사진 제공,개인 사정 및 기타,0,0,1,1
사진 및 영상 미모,사운드 및 영상 품질,1,0,0,1
사전예약 혜택,제품 출시 및 홍보,1,0,0,1
사전예약 할인,마케팅 및 프로모션,1,0,0,1
사용자 만족도 질문,사용자 경험 및 만족도,0,0,1,1
사용시간 57시간,제품 상태 및 사용,0,0,1,1
사용빈도 낮음,기타,0,0,1,1
사용 방법 학습 필요,문제 및 개선점,0,0,1,1
사용 방법 문의,기타,0,0,1,1
사용 방법 모름,사용자 경험 및 평가,0,1,0,1
사용 방법,기타,0,0,1,1
사용 미흡,추천 및 계획,0,1,0,1
사용 기회 제공,기타,1,0,0,1
사무실용 렌탈 추천,기타,1,0,0,1
사무실 PT용 추천,추천 및 후기,1,0,0,1
사기피해 사례 조회 권장,가격 및 거래,0,0,1,1
빵빵한 입체적인 사운드,기타,1,0,0,1
빨리 무르지 않음,기타,1,0,0,1
빠른 판매,가격 및 구매,1,0,0,1
빠른 처리,기타,0,0,1,1
빠른 조립,제품 디자인 및 조립,1,0,0,1
빠른 정리,개인 사정 및 기타,0,0,1,1
빠른 재고 확인,기타,1,0,0,1
빠른 재고 소진,구매 및 가격,0,1,0,1
빠른 서비스,기타,1,0,0,1
빠른 배송 보장,거래 및 구매,1,0,0,1
빠른 구매 의지,가격 및 구매,0,0,1,1
사용 방법 안내,기타,0,0,1,1
사용 빈도 감소,사용 빈도 및 문제,0,0,1,1
사용법 어려움,편리한 조작 및 사용자 경험,0,1,0,1
사용 빈도 우려,기타,0,0,1,1
사용법 안내,제품 사용 및 설치,0,0,1,1
사용방법 안내,제품 설치 및 사용,1,0,0,1
사용면 및 크기 고민,제품 특징 및 사용성,0,0,1,1
사용기간 1년 미만,기타,0,0,1,1
사용감 적은 제품 구매 가능,사용자 경험,0,0,1,1
사용감 거의 없음,제품 상태 및 가격,1,0,0,1
사용 횟수 3번,제품 상태 및 사용,0,0,1,1
사용 필요 없음,추천 및 계획,0,0,1,1
사용 편리성 향상,기타,1,0,0,1
사용 추천 요청,추천 및 후기,0,0,1,1
사용 적음,기타,0,0,1,1
사용 용이성,사용자 편의성,1,0,0,1
사용 용이,사용 편의성,1,0,0,1
사용 용도 없음,기타,0,0,1,1
사용 실수,기타,0,1,0,1
사용 시기 아쉬움,기타,0,1,0,1
사용 시간 짧음,기타,0,0,1,1
사용 시간 많음,사용 편의성,0,0,1,1
사용 시간,기타,0,0,1,1
복지몰 반값 이벤트,구매 및 이벤트,0,0,1,1
복잡한 연결선,사용자 경험,0,1,0,1
보호필름 티 안남,기타,1,0,0,1
바퀴가 달린 스탠드 형태,캠핑 및 휴대성,0,0,1,1
박스 풀셋,제품 상태 및 구성,0,0,1,1
박스 포함 구성품 모두 있음,가격 및 상태,0,0,1,1
박스 포함,기타,0,0,1,1
박스 찍힘,제품 상태 및 신뢰성,0,1,0,1
박스 보장,구매 및 거래,0,0,1,1
박스 모습,기타,0,0,1,1
박스 개봉 후 상태 확인,제품 상태 및 관리,0,0,1,1
바퀴로 인한 이동 불편,이동 및 설치,0,1,0,1
바퀴로 이동 가능,기타,1,0,0,1
바퀴가 달린 거치대,이동 및 설치,0,0,1,1
배드민턴 취미,기타,0,0,1,1
바퀴 장착 만족,사용 경험,1,0,0,1
바퀴 있는 제품 편리,제품 이동성 및 설치,1,0,0,1
바퀴 이동성,기능 및 성능,1,0,0,1
바퀴 달린 스탠드 선택,제품 디자인 및 이동성,0,0,1,1
바퀴 5개 부착,이동성과 설치,0,0,1,1
바퀴,제품 내구성 및 휴대성,1,0,0,1
바질페스토샐러드스파게티 구매,기타,0,0,1,1
바이미와 스탠바이미 모드 제공,기타,0,0,1,1
바이미고 사용,기타,1,0,0,1
박스/매뉴얼 없음,기타,0,0,1,1
박스개봉X,기타,0,0,1,1
박스만 판매,제품 상태 및 사용,0,0,1,1
박스미개봉 상품,제품 상태 및 포장,0,0,1,1
배달 서비스,기타,0,0,1,1
방탄 케이스 매력,부속품 및 추가 기능,1,0,0,1
방치 우려,기타,0,1,0,1
방안에서 시청 가능,제품 설치 및 사용 환경,1,0,0,1
방수형,제품 기능 및 디자인,0,0,1,1
방수 기능 없음,기타,0,0,1,1
방송에서의 제품 노출,기타,0,0,1,1
방송 존재감,기타,1,0,0,1
방문 설치 제공,사용 경험,1,0,0,1
발표 지연 사과,사용자 경험,0,0,1,1
발송 지연,기타 이슈 및 요구,0,1,0,1
발빠른 물량 확보,시장 및 소비자 반응,0,0,1,1
받침대 필요,기타,0,0,1,1
반품 사절,제품 상태 및 거래,0,0,1,1
반품,구매 및 거래,0,1,0,1
반전,기타,0,0,1,1
반값 특가,가격 및 거래,1,0,0,1
박테리아 서식 차단,기타,1,0,0,1
박스셋 구성품,제품 상태 및 구성,0,0,1,1
바이러스 제거,기타,0,0,1,1
바른 자세 유지,기타,0,0,1,1
바둑 체스 장기 가능,기타,1,0,0,1
미러링 가능,기능 및 연결성,0,0,1,1
미래 계획에 따른 구매 결정,사용 경험 및 후기,0,0,1,1
미디어 사용 고민,사용 환경 및 조건,0,0,1,1
미니멀리즘 디자인,디자인 및 스타일,1,0,0,1
미니멀 라이프에 적합,라이프스타일 적합성,0,0,1,1
미니TV,제품 및 기능 만족,0,0,1,1
미개봉신품,제품 상태 및 판매,0,0,1,1
미개봉 제품 우선,제품 상태 및 사용,0,0,1,1
미개봉 제품 구매 희망,제품 상태 및 사용,0,0,1,1
미개봉 우선 구매,제품 상태 및 구성,0,0,1,1
미개봉 스피커,제품 구성 및 특성,0,0,1,1
미개봉 세제품,제품 상태 및 거래,0,0,1,1
미개봉 선호,거래 및 구매 관련,0,0,1,1
미개봉 미사용 새상품,가격 및 상태,0,0,1,1
미 국방성 내구성 테스트 충족,기타,1,0,0,1
미 국방부 인정,기타,1,0,0,1
미 국방부 안정성 테스트 완료,내구성 및 안전성,1,0,0,1
미 국방부 안정성 테스트,기타,0,0,1,1
미 국방부 내구성 테스트 충족,내구성 및 안전성,1,0,0,1
미 국방부 내구성 기준 충족,내구성 및 안정성,1,0,0,1
미래의 불확실성,기타,0,0,1,1
미러링 기능 좋음,다양한 기능 및 설정,1,0,0,1
바닥 원판과 스탠드 결합 용이,기술 및 기능,1,0,0,1
미러링 딜레이,제품 성능 및 기능,0,1,0,1
바다 프린팅 디자인,기타,1,0,0,1
바나나브레드 시그니처 메뉴,기타,0,0,1,1
밀스펙 지원,보호 및 내구성,0,0,1,1
밀스펙,제품 내구성 및 품질,0,0,1,1
밀리터리 스탠다스 테스트 통과,제품 내구성 및 품질,1,0,0,1
밀리터리 스탠다드 통과,제품 기능 및 디자인,1,0,0,1
밀러터리 스탠다드 테스트 통과,제품 특성 및 디자인,1,0,0,1
믿을 수 있는 거래,가격 및 거래,0,0,1,1
민트급 제품 상태,제품 상태 및 사용,1,0,0,1
민트급 상태,제품 상태 및 사용,0,0,1,1
민음사 카프카 단편집 제공,기타,1,0,0,1
믹서기 휴대,이동 및 휴대성,0,0,1,1
미사용 제품 판매,제품 상태 및 판매,0,0,1,1
미사용 새제품,거래 및 구매,0,0,1,1
미사용 새상품,사용 경험 및 후기,1,0,0,1
미사용,기타,0,0,1,1
미러링 편리,기능 및 사용 편의성,1,0,0,1
미러링 용이,사용자 편의 및 기능,1,0,0,1
미러링 불편함,기능 및 성능,0,1,0,1
배달알바,기타,0,0,1,1
배민커넥트 추천,기타,0,0,1,1
보호필름 스크래치 및 지문방지,제품 기능 및 성능,1,0,0,1
벽걸이TV 선택,설치 및 이동성,0,0,1,1
변우석 스탠바이미 모델,문화 및 엔터테인먼트,0,0,1,1
변우석 스탠바이미 광고모델,기타,0,0,1,1
변우석 스탠바이미 광고,브랜드 및 광고,0,0,1,1
변우석 모델 선정,기타,0,0,1,1
변우석 모델 기용,마케팅 및 이벤트,0,0,1,1
변우석 모델,기타,0,0,1,1
변우석 글로벌 엠버서더 발탁,문화 및 엔터테인먼트,0,0,1,1
변우석 광고,제품 인지도 및 광고,0,0,1,1
변경된 패브릭 색상,기타,0,0,1,1
벽걸이 설치 고려,설치 및 이동성,0,0,1,1
배송 가능,기타,0,0,1,1
벽걸이 사용 가능,공간 활용 및 설치,1,0,0,1
벨락 코펠세트,제품 특징 및 구성,0,0,1,1
벨락 오덕그릴세트,제품 특징 및 구성,0,0,1,1
벤E. 킹의 노래 <Stand By Me> 사용,영화 및 문화,0,0,1,1
벤 E. 킹의 노래,영화 및 문화,0,0,1,1
베젤 차이,디자인 및 외관,0,1,0,1
베젤 미포함 크기,제품 크기 및 디자인,0,0,1,1
베이징 행사에서 인우와 만남,기타,0,0,1,1
베이지 컬러 캐리백,부속품 및 추가 기능,0,0,1,1
변우석 스탠바이미 모델 발탁,광고 및 마케팅,0,0,1,1
변우석 출연,문화 및 엔터테인먼트,0,0,1,1
변우석 포토카드 출시,문화 및 엔터테인먼트,0,0,1,1
변우석의 매력,제품 인지도 및 광고,1,0,0,1
보조티비로 사용,사용 용도 및 환경,0,0,1,1
보조배터리 연결 문제,사용 편의성 및 기능,0,1,0,1
보안 패치,보안 및 안전,1,0,0,1
보안 철저,기타,0,0,1,1
보물같은 장소,기타,1,0,0,1
보드게임 탑재,제품 기능 및 성능,0,0,1,1
보드게임 및 영화 관람,기타,0,0,1,1
보드게임,기타,0,0,1,1
보관 중,제품 및 가격 정보,0,0,1,1
별점 높음,구매 및 소비자 반응,1,0,0,1
별점 7점,기타,0,0,1,1
별점 5.0점,소비자 반응,1,0,0,1
별점 4.5점,고객 경험 및 리뷰,1,0,0,1
별점 4.0점,기타,0,0,1,1
별매 거치대 필요 없음,기타,0,0,1,1
별도의 설치 불필요,제품 활용 및 기능,0,0,1,1
별도 스탠드 필요,제품 및 액세서리,0,0,1,1
별도 구매 필요,기타,0,0,1,1
변호사 사망기사,기타,0,0,1,1
베이지 컬러 만족,디자인 및 공간 활용,1,0,0,1
베이스 및 스탠드 장착 방법,기타,0,0,1,1
베스트 판매 모델,제품 인기 및 추천,1,0,0,1
배터리 있음,제품 특징 및 사용,0,0,1,1
배터리 용량 제한 충족,기타,1,0,0,1
배터리 용량 위탁수하물 기준 이하,기타,0,0,1,1
배터리 없음,기타,0,0,1,1
배터리 아쉬움,기타,0,1,0,1
배터리 수명 짧음,기타,0,1,0,1
배터리 사용 시간,사용 편의성 및 기능,0,0,1,1
배터리 부족,제품 불만 및 문제,0,1,0,1
배터리 무게,기타,0,0,1,1
배터리 내장 스탠드 일체형,기타,0,0,1,1
배터리 내장,제품 특징 및 사용,0,0,1,1
배터리 기대 이하,제품 기능 및 사양,0,1,0,1
배터리 관리,기타,1,0,0,1
배신감,기타,0,1,0,1
배송일 지정 가능,배송 및 설치,1,0,0,1
배송비 별도,가격 및 거래,0,0,1,1
배송변경으로 인한 판매,배송 및 포장,0,0,1,1
배송박스 보존,배송 및 포장,0,0,1,1
배송 일정,배송 및 포장,0,0,1,1
배송 예정,기타,0,0,1,1
배터리 유상 교체,기타,0,0,1,1
배터리 지속 시간,기타 기능 및 옵션,0,0,1,1
베스트 리뷰상 제공,고객 경험 및 리뷰,0,0,1,1
배터리 지속시간,기타,0,0,1,1
베사홀 장착 가능,제품 디자인 및 기능,0,0,1,1
베사홀 없음,기타,0,0,1,1
베란다 캠핑,제품 활용 및 기능,0,0,1,1
베란다 인테리어,제품 활용 및 기능,0,0,1,1
법적 분쟁,기타,0,0,1,1
번역 만족,기타,1,0,0,1
번거로운 셋팅,설치 및 사용 불편,0,1,0,1
버전 차이,제품 비교 및 차별성,0,0,1,1
백화점 쇼핑 선호,기타,0,0,1,1
백화점 VIP 할인 혜택,가격 및 혜택,1,0,0,1
백지영의 스탠바이미 공개,기타,0,0,1,1
백지영의 명곡 기억,기타,0,0,1,1
백지영의 OST 작업,기타,0,0,1,1
백설공주 살인사건 영화 정보,영화 관련,0,0,1,1
배터리타임 불확실,기타,0,0,1,1
배터리모드 사용 안함,제품 상태 및 사용,0,0,1,1
배터리 포함,기타,1,0,0,1
배터리 탑재,기타,0,0,1,1
배터리 충전기 형식의 전원 케이블,제품 기능 및 사용성,0,0,1,1
힙한 제품,디자인 및 스타일,1,0,0,1